year,state,state_po,county,dem,gop,other,total
2012,Arizona,AZ,APACHE COUNTY,17147,8250,451,25848
2012,Arizona,AZ,COCHISE COUNTY,18546,29497,960,49003
2012,Arizona,AZ,COCONINO COUNTY,29257,21220,1254,51731
2012,Arizona,AZ,GILA COUNTY,7697,13455,376,21528
2012,Arizona,AZ,GRAHAM COUNTY,3609,8076,170,11855
2012,Arizona,AZ,GREENLEE COUNTY,1310,1592,72,2974
2012,Arizona,AZ,LA PAZ COUNTY,1880,3714,123,5717
2012,Arizona,AZ,MARICOPA COUNTY,602288,749885,24385,1376558
2012,Arizona,AZ,MOHAVE COUNTY,19533,49168,1309,70010
2012,Arizona,AZ,NAVAJO COUNTY,16945,19884,506,37335
2012,Arizona,AZ,PIMA COUNTY,201251,174779,6220,382250
2012,Arizona,AZ,PINAL COUNTY,44306,62079,1930,108315
2012,Arizona,AZ,SANTA CRUZ COUNTY,9486,4235,173,13894
2012,Arizona,AZ,YAVAPAI COUNTY,33918,64468,1897,100283
2012,Arizona,AZ,YUMA COUNTY,18059,23352,542,41953
2012,Florida,FL,ALACHUA COUNTY,69699,48797,1922,120418
2012,Florida,FL,BAKER COUNTY,2311,8975,82,11368
2012,Florida,FL,BAY COUNTY,22051,56876,934,79861
2012,Florida,FL,BRADFORD COUNTY,3325,8219,91,11635
2012,Florida,FL,BREVARD COUNTY,122993,159300,3266,285559
2012,Florida,FL,BROWARD COUNTY,508312,244101,4009,756422
2012,Florida,FL,CALHOUN COUNTY,1664,4366,122,6152
2012,Florida,FL,CHARLOTTE COUNTY,35906,47996,780,84682
2012,Florida,FL,CITRUS COUNTY,28460,44662,813,73935
2012,Florida,FL,CLAY COUNTY,25759,70022,808,96589
2012,Florida,FL,COLLIER COUNTY,51698,96520,894,149112
2012,Florida,FL,COLUMBIA COUNTY,8462,18429,272,27163
2012,Florida,FL,DESOTO COUNTY,4174,5587,104,9865
2012,Florida,FL,DIXIE COUNTY,1798,5052,91,6941
2012,Florida,FL,DUVAL COUNTY,196737,211615,3496,411848
2012,Florida,FL,ESCAMBIA COUNTY,58185,88711,1606,148502
2012,Florida,FL,FLAGLER COUNTY,23207,26969,419,50595
2012,Florida,FL,FRANKLIN COUNTY,1845,3570,59,5474
2012,Florida,FL,GADSDEN COUNTY,15770,6630,99,22499
2012,Florida,FL,GILCHRIST COUNTY,1885,5917,107,7909
2012,Florida,FL,GLADES COUNTY,1603,2344,42,3989
2012,Florida,FL,GULF COUNTY,2014,4995,99,7108
2012,Florida,FL,HAMILTON COUNTY,2228,3138,41,5407
2012,Florida,FL,HARDEE COUNTY,2463,4696,67,7226
2012,Florida,FL,HENDRY COUNTY,4751,5355,79,10185
2012,Florida,FL,HERNANDO COUNTY,37830,44938,899,83667
2012,Florida,FL,HIGHLANDS COUNTY,16148,25915,381,42444
2012,Florida,FL,HILLSBOROUGH COUNTY,286467,250186,5449,542102
2012,Florida,FL,HOLMES COUNTY,1264,6919,91,8274
2012,Florida,FL,INDIAN RIVER COUNTY,27492,43450,522,71464
2012,Florida,FL,JACKSON COUNTY,7342,13418,181,20941
2012,Florida,FL,JEFFERSON COUNTY,3945,3808,55,7808
2012,Florida,FL,LAFAYETTE COUNTY,687,2668,44,3399
2012,Florida,FL,LAKE COUNTY,61799,87643,1369,150811
2012,Florida,FL,LEE COUNTY,110157,154163,1846,266166
2012,Florida,FL,LEON COUNTY,90881,55805,1667,148353
2012,Florida,FL,LEVY COUNTY,6119,12054,226,18399
2012,Florida,FL,LIBERTY COUNTY,942,2301,41,3284
2012,Florida,FL,MADISON COUNTY,4176,4474,65,8715
2012,Florida,FL,MANATEE COUNTY,66503,85627,1361,153491
2012,Florida,FL,MARION COUNTY,66831,93043,1511,161385
2012,Florida,FL,MARTIN COUNTY,30107,48183,583,78873
2012,Florida,FL,MIAMI-DADE COUNTY,541440,332981,3893,878314
2012,Florida,FL,MONROE COUNTY,19404,19234,419,39057
2012,Florida,FL,NASSAU COUNTY,10251,29929,348,40528
2012,Florida,FL,OKALOOSA COUNTY,23421,70168,1209,94798
2012,Florida,FL,OKEECHOBEE COUNTY,4856,7328,140,12324
2012,Florida,FL,ORANGE COUNTY,273665,188589,4105,466359
2012,Florida,FL,OSCEOLA COUNTY,67239,40592,867,108698
2012,Florida,FL,PALM BEACH COUNTY,349651,247398,3672,600721
2012,Florida,FL,PASCO COUNTY,98263,112427,2883,213573
2012,Florida,FL,PINELLAS COUNTY,239104,213258,5340,457702
2012,Florida,FL,POLK COUNTY,114622,131577,2484,248683
2012,Florida,FL,PUTNAM COUNTY,11667,19326,331,31324
2012,Florida,FL,ST. JOHNS COUNTY,35190,78513,1092,114795
2012,Florida,FL,ST. LUCIE COUNTY,65869,56202,956,123027
2012,Florida,FL,SANTA ROSA COUNTY,17768,58186,892,76846
2012,Florida,FL,SARASOTA COUNTY,95119,110504,1857,207480
2012,Florida,FL,SEMINOLE COUNTY,96445,109943,2232,208620
2012,Florida,FL,SUMTER COUNTY,19524,40646,309,60479
2012,Florida,FL,SUWANNEE COUNTY,4751,12672,206,17629
2012,Florida,FL,TAYLOR COUNTY,2764,6249,107,9120
2012,Florida,FL,UNION COUNTY,1339,3980,74,5393
2012,Florida,FL,VOLUSIA COUNTY,114748,117490,2298,234536
2012,Florida,FL,WAKULLA COUNTY,5175,9290,195,14660
2012,Florida,FL,WALTON COUNTY,6671,21490,333,28494
2012,Florida,FL,WASHINGTON COUNTY,2820,8038,141,10999
2012,Georgia,GA,APPLING COUNTY,1758,5233,95,7086
2012,Georgia,GA,ATKINSON COUNTY,930,1938,34,2902
2012,Georgia,GA,BACON COUNTY,791,3093,47,3931
2012,Georgia,GA,BAKER COUNTY,794,785,10,1589
2012,Georgia,GA,BALDWIN COUNTY,8483,7589,166,16238
2012,Georgia,GA,BANKS COUNTY,780,5354,61,6195
2012,Georgia,GA,BARROW COUNTY,6028,18725,446,25199
2012,Georgia,GA,BARTOW COUNTY,8396,26876,530,35802
2012,Georgia,GA,BEN HILL COUNTY,2512,3396,48,5956
2012,Georgia,GA,BERRIEN COUNTY,1273,4843,85,6201
2012,Georgia,GA,BIBB COUNTY,38585,25623,510,64718
2012,Georgia,GA,BLECKLEY COUNTY,1269,3587,51,4907
2012,Georgia,GA,BRANTLEY COUNTY,939,4964,99,6002
2012,Georgia,GA,BROOKS COUNTY,3138,3554,50,6742
2012,Georgia,GA,BRYAN COUNTY,3707,9560,186,13453
2012,Georgia,GA,BULLOCH COUNTY,9593,14174,318,24085
2012,Georgia,GA,BURKE COUNTY,5405,4301,73,9779
2012,Georgia,GA,BUTTS COUNTY,2968,6306,107,9381
2012,Georgia,GA,CALHOUN COUNTY,1298,883,7,2188
2012,Georgia,GA,CAMDEN COUNTY,6377,11343,263,17983
2012,Georgia,GA,CANDLER COUNTY,1157,2344,27,3528
2012,Georgia,GA,CARROLL COUNTY,12688,28280,581,41549
2012,Georgia,GA,CATOOSA COUNTY,5365,17858,455,23678
2012,Georgia,GA,CHARLTON COUNTY,1197,2527,40,3764
2012,Georgia,GA,CHATHAM COUNTY,60246,47204,1178,108628
2012,Georgia,GA,CHATTAHOOCHEE COUNTY,729,735,26,1490
2012,Georgia,GA,CHATTOOGA COUNTY,2232,5452,138,7822
2012,Georgia,GA,CHEROKEE COUNTY,19841,76514,1865,98220
2012,Georgia,GA,CLARKE COUNTY,25431,13815,1122,40368
2012,Georgia,GA,CLAY COUNTY,862,537,3,1402
2012,Georgia,GA,CLAYTON COUNTY,81479,14164,424,96067
2012,Georgia,GA,CLINCH COUNTY,852,1598,22,2472
2012,Georgia,GA,COBB COUNTY,133124,171722,5270,310116
2012,Georgia,GA,COFFEE COUNTY,5057,9248,149,14454
2012,Georgia,GA,COLQUITT COUNTY,3973,9243,112,13328
2012,Georgia,GA,COLUMBIA COUNTY,16451,41765,707,58923
2012,Georgia,GA,COOK COUNTY,2042,3935,54,6031
2012,Georgia,GA,COWETA COUNTY,15168,39653,734,55555
2012,Georgia,GA,CRAWFORD COUNTY,1706,3368,59,5133
2012,Georgia,GA,CRISP COUNTY,3167,4182,47,7396
2012,Georgia,GA,DADE COUNTY,1411,4471,138,6020
2012,Georgia,GA,DAWSON COUNTY,1241,8847,156,10244
2012,Georgia,GA,DECATUR COUNTY,4591,5824,70,10485
2012,Georgia,GA,DEKALB COUNTY,238224,64392,3649,306265
2012,Georgia,GA,DODGE COUNTY,2442,5214,77,7733
2012,Georgia,GA,DOOLY COUNTY,2285,1985,28,4298
2012,Georgia,GA,DOUGHERTY COUNTY,26295,11449,175,37919
2012,Georgia,GA,DOUGLAS COUNTY,28441,26241,585,55267
2012,Georgia,GA,EARLY COUNTY,2765,2557,31,5353
2012,Georgia,GA,ECHOLS COUNTY,173,917,12,1102
2012,Georgia,GA,EFFINGHAM COUNTY,4947,15596,273,20816
2012,Georgia,GA,ELBERT COUNTY,3181,4859,103,8143
2012,Georgia,GA,EMANUEL COUNTY,2927,5100,56,8083
2012,Georgia,GA,EVANS COUNTY,1268,2268,27,3563
2012,Georgia,GA,FANNIN COUNTY,2028,7857,132,10017
2012,Georgia,GA,FAYETTE COUNTY,19736,38075,757,58568
2012,Georgia,GA,FLOYD COUNTY,9640,22733,456,32829
2012,Georgia,GA,FORSYTH COUNTY,14571,65908,1252,81731
2012,Georgia,GA,FRANKLIN COUNTY,1499,6114,149,7762
2012,Georgia,GA,FULTON COUNTY,255470,137124,4819,397413
2012,Georgia,GA,GILMER COUNTY,1958,8926,134,11018
2012,Georgia,GA,GLASCOCK COUNTY,176,1135,22,1333
2012,Georgia,GA,GLYNN COUNTY,11950,20893,290,33133
2012,Georgia,GA,GORDON COUNTY,3440,13197,260,16897
2012,Georgia,GA,GRADY COUNTY,3419,5924,53,9396
2012,Georgia,GA,GREENE COUNTY,3201,5071,51,8323
2012,Georgia,GA,GWINNETT COUNTY,132509,159855,4364,296728
2012,Georgia,GA,HABERSHAM COUNTY,2301,12166,174,14641
2012,Georgia,GA,HALL COUNTY,12999,47481,884,61364
2012,Georgia,GA,HANCOCK COUNTY,3308,769,11,4088
2012,Georgia,GA,HARALSON COUNTY,1789,8446,141,10376
2012,Georgia,GA,HARRIS COUNTY,4145,11197,146,15488
2012,Georgia,GA,HART COUNTY,2870,6517,124,9511
2012,Georgia,GA,HEARD COUNTY,948,3160,64,4172
2012,Georgia,GA,HENRY COUNTY,43761,46774,843,91378
2012,Georgia,GA,HOUSTON COUNTY,22702,34662,692,58056
2012,Georgia,GA,IRWIN COUNTY,1141,2538,30,3709
2012,Georgia,GA,JACKSON COUNTY,4238,19135,331,23704
2012,Georgia,GA,JASPER COUNTY,1845,4136,50,6031
2012,Georgia,GA,JEFF DAVIS COUNTY,1275,3996,65,5336
2012,Georgia,GA,JEFFERSON COUNTY,4261,2999,38,7298
2012,Georgia,GA,JENKINS COUNTY,1488,1887,15,3390
2012,Georgia,GA,JOHNSON COUNTY,1305,2440,27,3772
2012,Georgia,GA,JONES COUNTY,4274,7744,87,12105
2012,Georgia,GA,LAMAR COUNTY,2602,4899,91,7592
2012,Georgia,GA,LANIER COUNTY,1114,1820,38,2972
2012,Georgia,GA,LAURENS COUNTY,7513,11950,141,19604
2012,Georgia,GA,LEE COUNTY,3196,10314,118,13628
2012,Georgia,GA,LIBERTY COUNTY,10457,5565,148,16170
2012,Georgia,GA,LINCOLN COUNTY,1586,2807,33,4426
2012,Georgia,GA,LONG COUNTY,1442,2306,54,3802
2012,Georgia,GA,LOWNDES COUNTY,17470,21327,340,39137
2012,Georgia,GA,LUMPKIN COUNTY,2055,8647,203,10905
2012,Georgia,GA,MCDUFFIE COUNTY,4044,5475,73,9592
2012,Georgia,GA,MCINTOSH COUNTY,2864,3409,68,6341
2012,Georgia,GA,MACON COUNTY,3211,1545,25,4781
2012,Georgia,GA,MADISON COUNTY,2494,8443,167,11104
2012,Georgia,GA,MARION COUNTY,1412,1733,25,3170
2012,Georgia,GA,MERIWETHER COUNTY,4331,4856,77,9264
2012,Georgia,GA,MILLER COUNTY,852,1905,18,2775
2012,Georgia,GA,MITCHELL COUNTY,4081,4155,39,8275
2012,Georgia,GA,MONROE COUNTY,3785,8361,131,12277
2012,Georgia,GA,MONTGOMERY COUNTY,1135,2662,35,3832
2012,Georgia,GA,MORGAN COUNTY,2753,6186,88,9027
2012,Georgia,GA,MURRAY COUNTY,2542,8443,232,11217
2012,Georgia,GA,MUSCOGEE COUNTY,42573,27510,520,70603
2012,Georgia,GA,NEWTON COUNTY,21851,20982,401,43234
2012,Georgia,GA,OCONEE COUNTY,4421,13098,298,17817
2012,Georgia,GA,OGLETHORPE COUNTY,1914,4251,108,6273
2012,Georgia,GA,PAULDING COUNTY,15825,40846,728,57399
2012,Georgia,GA,PEACH COUNTY,6148,5287,81,11516
2012,Georgia,GA,PICKENS COUNTY,1975,10547,158,12680
2012,Georgia,GA,PIERCE COUNTY,1124,5667,55,6846
2012,Georgia,GA,PIKE COUNTY,1356,6668,85,8109
2012,Georgia,GA,POLK COUNTY,3615,9811,182,13608
2012,Georgia,GA,PULASKI COUNTY,1219,2444,19,3682
2012,Georgia,GA,PUTNAM COUNTY,2926,6215,81,9222
2012,Georgia,GA,QUITMAN COUNTY,612,510,6,1128
2012,Georgia,GA,RABUN COUNTY,1559,5754,150,7463
2012,Georgia,GA,RANDOLPH COUNTY,1770,1271,17,3058
2012,Georgia,GA,RICHMOND COUNTY,52560,25845,615,79020
2012,Georgia,GA,ROCKDALE COUNTY,22023,15716,346,38085
2012,Georgia,GA,SCHLEY COUNTY,448,1286,14,1748
2012,Georgia,GA,SCREVEN COUNTY,2774,3287,39,6100
2012,Georgia,GA,SEMINOLE COUNTY,1478,2245,46,3769
2012,Georgia,GA,SPALDING COUNTY,9898,14911,279,25088
2012,Georgia,GA,STEPHENS COUNTY,2131,7221,146,9498
2012,Georgia,GA,STEWART COUNTY,1323,745,8,2076
2012,Georgia,GA,SUMTER COUNTY,6375,5378,78,11831
2012,Georgia,GA,TALBOT COUNTY,2265,1202,24,3491
2012,Georgia,GA,TALIAFERRO COUNTY,636,323,4,963
2012,Georgia,GA,TATTNALL COUNTY,1897,4706,64,6667
2012,Georgia,GA,TAYLOR COUNTY,1572,1948,18,3538
2012,Georgia,GA,TELFAIR COUNTY,1805,2480,51,4336
2012,Georgia,GA,TERRELL COUNTY,2544,1834,20,4398
2012,Georgia,GA,THOMAS COUNTY,7653,11156,144,18953
2012,Georgia,GA,TIFT COUNTY,4660,9185,82,13927
2012,Georgia,GA,TOOMBS COUNTY,2746,6524,74,9344
2012,Georgia,GA,TOWNS COUNTY,1273,4876,62,6211
2012,Georgia,GA,TREUTLEN COUNTY,1074,1652,24,2750
2012,Georgia,GA,TROUP COUNTY,10547,15179,260,25986
2012,Georgia,GA,TURNER COUNTY,1510,2028,21,3559
2012,Georgia,GA,TWIGGS COUNTY,2270,1907,25,4202
2012,Georgia,GA,UNION COUNTY,2139,8773,167,11079
2012,Georgia,GA,UPSON COUNTY,3959,7230,74,11263
2012,Georgia,GA,WALKER COUNTY,5274,16247,375,21896
2012,Georgia,GA,WALTON COUNTY,8148,29036,428,37612
2012,Georgia,GA,WARE COUNTY,3900,7941,98,11939
2012,Georgia,GA,WARREN COUNTY,1529,990,7,2526
2012,Georgia,GA,WASHINGTON COUNTY,4714,4035,59,8808
2012,Georgia,GA,WAYNE COUNTY,2596,7557,116,10269
2012,Georgia,GA,WEBSTER COUNTY,582,601,4,1187
2012,Georgia,GA,WHEELER COUNTY,772,1366,22,2160
2012,Georgia,GA,WHITE COUNTY,1671,8651,166,10488
2012,Georgia,GA,WHITFIELD COUNTY,7210,19305,361,26876
2012,Georgia,GA,WILCOX COUNTY,1060,2053,16,3129
2012,Georgia,GA,WILKES COUNTY,2087,2635,39,4761
2012,Georgia,GA,WILKINSON COUNTY,2181,2246,23,4450
2012,Georgia,GA,WORTH COUNTY,2487,5869,63,8419
2012,Michigan,MI,ALCONA COUNTY,2472,3571,61,6104
2012,Michigan,MI,ALGER COUNTY,2212,2330,76,4618
2012,Michigan,MI,ALLEGAN COUNTY,20806,31123,690,52619
2012,Michigan,MI,ALPENA COUNTY,6549,7298,167,14014
2012,Michigan,MI,ANTRIM COUNTY,5107,7917,171,13195
2012,Michigan,MI,ARENAC COUNTY,3669,4057,115,7841
2012,Michigan,MI,BARAGA COUNTY,1574,1866,50,3490
2012,Michigan,MI,BARRY COUNTY,11491,16655,366,28512
2012,Michigan,MI,BAY COUNTY,27877,24911,593,53381
2012,Michigan,MI,BENZIE COUNTY,4685,5075,141,9901
2012,Michigan,MI,BERRIEN COUNTY,33465,38209,823,72497
2012,Michigan,MI,BRANCH COUNTY,6913,10035,199,17147
2012,Michigan,MI,CALHOUN COUNTY,29267,28333,727,58327
2012,Michigan,MI,CASS COUNTY,9591,12659,240,22490
2012,Michigan,MI,CHARLEVOIX COUNTY,5939,8000,151,14090
2012,Michigan,MI,CHEBOYGAN COUNTY,5831,7286,194,13311
2012,Michigan,MI,CHIPPEWA COUNTY,7100,8278,186,15564
2012,Michigan,MI,CLARE COUNTY,6338,6988,178,13504
2012,Michigan,MI,CLINTON COUNTY,18191,20650,394,39235
2012,Michigan,MI,CRAWFORD COUNTY,2994,3744,76,6814
2012,Michigan,MI,DELTA COUNTY,8330,9534,186,18050
2012,Michigan,MI,DICKINSON COUNTY,4952,7688,170,12810
2012,Michigan,MI,EATON COUNTY,27913,26197,678,54788
2012,Michigan,MI,EMMET COUNTY,7225,10253,231,17709
2012,Michigan,MI,GENESEE COUNTY,128978,71808,2147,202933
2012,Michigan,MI,GLADWIN COUNTY,5760,6661,162,12583
2012,Michigan,MI,GOGEBIC COUNTY,4058,3444,74,7576
2012,Michigan,MI,GRAND TRAVERSE COUNTY,20875,26534,590,47999
2012,Michigan,MI,GRATIOT COUNTY,7610,8241,184,16035
2012,Michigan,MI,HILLSDALE COUNTY,7106,11727,267,19100
2012,Michigan,MI,HOUGHTON COUNTY,6801,8196,285,15282
2012,Michigan,MI,HURON COUNTY,6518,8806,160,15484
2012,Michigan,MI,INGHAM COUNTY,80847,45306,1757,127910
2012,Michigan,MI,IONIA COUNTY,11018,14315,428,25761
2012,Michigan,MI,IOSCO COUNTY,6242,6909,193,13344
2012,Michigan,MI,IRON COUNTY,2687,3224,77,5988
2012,Michigan,MI,ISABELLA COUNTY,13038,10800,281,24119
2012,Michigan,MI,JACKSON COUNTY,32301,36298,847,69446
2012,Michigan,MI,KALAMAZOO COUNTY,69051,52662,1465,123178
2012,Michigan,MI,KALKASKA COUNTY,3272,4901,126,8299
2012,Michigan,MI,KENT COUNTY,133408,155925,3652,292985
2012,Michigan,MI,KEWEENAW COUNTY,582,774,36,1392
2012,Michigan,MI,LAKE COUNTY,2752,2487,48,5287
2012,Michigan,MI,LAPEER COUNTY,18796,23734,585,43115
2012,Michigan,MI,LEELANAU COUNTY,6576,7483,117,14176
2012,Michigan,MI,LENAWEE COUNTY,21776,22351,597,44724
2012,Michigan,MI,LIVINGSTON COUNTY,37216,60083,1038,98337
2012,Michigan,MI,LUCE COUNTY,991,1580,25,2596
2012,Michigan,MI,MACKINAC COUNTY,2652,3397,50,6099
2012,Michigan,MI,MACOMB COUNTY,208016,191913,4157,404086
2012,Michigan,MI,MANISTEE COUNTY,6473,5737,192,12402
2012,Michigan,MI,MARQUETTE COUNTY,18115,13606,473,32194
2012,Michigan,MI,MASON COUNTY,6856,7580,168,14604
2012,Michigan,MI,MECOSTA COUNTY,7515,9176,222,16913
2012,Michigan,MI,MENOMINEE COUNTY,5242,5564,117,10923
2012,Michigan,MI,MIDLAND COUNTY,17450,23919,385,41754
2012,Michigan,MI,MISSAUKEE COUNTY,2274,4665,88,7027
2012,Michigan,MI,MONROE COUNTY,36310,35593,950,72853
2012,Michigan,MI,MONTCALM COUNTY,11430,13621,380,25431
2012,Michigan,MI,MONTMORENCY COUNTY,2049,2928,74,5051
2012,Michigan,MI,MUSKEGON COUNTY,44436,30884,843,76163
2012,Michigan,MI,NEWAYGO COUNTY,8728,12457,293,21478
2012,Michigan,MI,OAKLAND COUNTY,349002,296514,6091,651607
2012,Michigan,MI,OCEANA COUNTY,5063,6239,148,11450
2012,Michigan,MI,OGEMAW COUNTY,4791,5437,133,10361
2012,Michigan,MI,ONTONAGON COUNTY,1586,1906,47,3539
2012,Michigan,MI,OSCEOLA COUNTY,3981,6141,156,10278
2012,Michigan,MI,OSCODA COUNTY,1657,2308,77,4042
2012,Michigan,MI,OTSEGO COUNTY,4681,7011,140,11832
2012,Michigan,MI,OTTAWA COUNTY,42737,88166,1409,132312
2012,Michigan,MI,PRESQUE ISLE COUNTY,3192,3794,94,7080
2012,Michigan,MI,ROSCOMMON COUNTY,6198,6701,133,13032
2012,Michigan,MI,SAGINAW COUNTY,54381,42720,961,98062
2012,Michigan,MI,ST. CLAIR COUNTY,33983,39271,927,74181
2012,Michigan,MI,ST. JOSEPH COUNTY,10112,12978,251,23341
2012,Michigan,MI,SANILAC COUNTY,7212,10963,194,18369
2012,Michigan,MI,SCHOOLCRAFT COUNTY,1865,2142,41,4048
2012,Michigan,MI,SHIAWASSEE COUNTY,17197,15962,520,33679
2012,Michigan,MI,TUSCOLA COUNTY,11425,14240,338,26003
2012,Michigan,MI,VAN BUREN COUNTY,16290,16141,406,32837
2012,Michigan,MI,WASHTENAW COUNTY,120890,56412,2290,179592
2012,Michigan,MI,WAYNE COUNTY,595846,213814,6165,815825
2012,Michigan,MI,WEXFORD COUNTY,6184,8450,219,14853
2012,North Carolina,NC,ALAMANCE COUNTY,28875,38170,731,67776
2012,North Carolina,NC,ALEXANDER COUNTY,4611,12253,332,17196
2012,North Carolina,NC,ALLEGHANY COUNTY,1583,3390,94,5067
2012,North Carolina,NC,ANSON COUNTY,7019,4166,71,11256
2012,North Carolina,NC,ASHE COUNTY,4116,8242,252,12610
2012,North Carolina,NC,AVERY COUNTY,1882,5766,111,7759
2012,North Carolina,NC,BEAUFORT COUNTY,9435,13977,208,23620
2012,North Carolina,NC,BERTIE COUNTY,6695,3387,41,10123
2012,North Carolina,NC,BLADEN COUNTY,8062,7748,147,15957
2012,North Carolina,NC,BRUNSWICK COUNTY,22038,34743,581,57362
2012,North Carolina,NC,BUNCOMBE COUNTY,70625,54701,2370,127696
2012,North Carolina,NC,BURKE COUNTY,13701,22267,576,36544
2012,North Carolina,NC,CABARRUS COUNTY,32849,49557,1160,83566
2012,North Carolina,NC,CALDWELL COUNTY,10898,23229,605,34732
2012,North Carolina,NC,CAMDEN COUNTY,1508,3109,87,4704
2012,North Carolina,NC,CARTERET COUNTY,10301,24775,441,35517
2012,North Carolina,NC,CASWELL COUNTY,5348,5594,97,11039
2012,North Carolina,NC,CATAWBA COUNTY,24069,44538,994,69601
2012,North Carolina,NC,CHATHAM COUNTY,18361,16665,408,35434
2012,North Carolina,NC,CHEROKEE COUNTY,3378,9278,211,12867
2012,North Carolina,NC,CHOWAN COUNTY,3556,3891,58,7505
2012,North Carolina,NC,CLAY COUNTY,1579,3973,90,5642
2012,North Carolina,NC,CLEVELAND COUNTY,17062,25793,485,43340
2012,North Carolina,NC,COLUMBUS COUNTY,11050,12941,252,24243
2012,North Carolina,NC,CRAVEN COUNTY,18763,26928,479,46170
2012,North Carolina,NC,CUMBERLAND COUNTY,75792,50666,1183,127641
2012,North Carolina,NC,CURRITUCK COUNTY,3562,7496,246,11304
2012,North Carolina,NC,DARE COUNTY,7393,10248,333,17974
2012,North Carolina,NC,DAVIDSON COUNTY,20624,49383,928,70935
2012,North Carolina,NC,DAVIE COUNTY,5735,14687,248,20670
2012,North Carolina,NC,DUPLIN COUNTY,9033,11416,143,20592
2012,North Carolina,NC,DURHAM COUNTY,111224,33769,1742,146735
2012,North Carolina,NC,EDGECOMBE COUNTY,18310,8546,116,26972
2012,North Carolina,NC,FORSYTH COUNTY,92323,79768,1978,174069
2012,North Carolina,NC,FRANKLIN COUNTY,13436,14603,350,28389
2012,North Carolina,NC,GASTON COUNTY,33171,56138,1174,90483
2012,North Carolina,NC,GATES COUNTY,2786,2564,46,5396
2012,North Carolina,NC,GRAHAM COUNTY,1119,2750,78,3947
2012,North Carolina,NC,GRANVILLE COUNTY,13598,12405,272,26275
2012,North Carolina,NC,GREENE COUNTY,3778,4411,47,8236
2012,North Carolina,NC,GUILFORD COUNTY,146365,104789,2698,253852
2012,North Carolina,NC,HALIFAX COUNTY,17176,8763,140,26079
2012,North Carolina,NC,HARNETT COUNTY,17331,25565,519,43415
2012,North Carolina,NC,HAYWOOD COUNTY,11833,15633,508,27974
2012,North Carolina,NC,HENDERSON COUNTY,18642,32994,756,52392
2012,North Carolina,NC,HERTFORD COUNTY,7843,3007,68,10918
2012,North Carolina,NC,HOKE COUNTY,10076,6819,194,17089
2012,North Carolina,NC,HYDE COUNTY,1163,1193,27,2383
2012,North Carolina,NC,IREDELL COUNTY,26076,49299,990,76365
2012,North Carolina,NC,JACKSON COUNTY,8095,8254,352,16701
2012,North Carolina,NC,JOHNSTON COUNTY,27290,48427,974,76691
2012,North Carolina,NC,JONES COUNTY,2352,2837,41,5230
2012,North Carolina,NC,LEE COUNTY,10801,13158,280,24239
2012,North Carolina,NC,LENOIR COUNTY,13948,13980,158,28086
2012,North Carolina,NC,LINCOLN COUNTY,11024,25267,484,36775
2012,North Carolina,NC,MCDOWELL COUNTY,6031,11775,293,18099
2012,North Carolina,NC,MACON COUNTY,5712,10835,314,16861
2012,North Carolina,NC,MADISON COUNTY,4484,5404,225,10113
2012,North Carolina,NC,MARTIN COUNTY,6583,5995,74,12652
2012,North Carolina,NC,MECKLENBURG COUNTY,272262,171668,4970,448900
2012,North Carolina,NC,MITCHELL COUNTY,1838,5806,121,7765
2012,North Carolina,NC,MONTGOMERY COUNTY,4706,6404,121,11231
2012,North Carolina,NC,MOORE COUNTY,16505,29495,415,46415
2012,North Carolina,NC,NASH COUNTY,24313,23842,337,48492
2012,North Carolina,NC,NEW HANOVER COUNTY,48668,53385,1575,103628
2012,North Carolina,NC,NORTHAMPTON COUNTY,7232,3483,41,10756
2012,North Carolina,NC,ONSLOW COUNTY,18490,32243,702,51435
2012,North Carolina,NC,ORANGE COUNTY,53901,21539,1317,76757
2012,North Carolina,NC,PAMLICO COUNTY,2647,4051,64,6762
2012,North Carolina,NC,PASQUOTANK COUNTY,10282,7633,192,18107
2012,North Carolina,NC,PENDER COUNTY,9632,14617,278,24527
2012,North Carolina,NC,PERQUIMANS COUNTY,2759,3822,71,6652
2012,North Carolina,NC,PERSON COUNTY,8418,10496,192,19106
2012,North Carolina,NC,PITT COUNTY,41843,36214,799,78856
2012,North Carolina,NC,POLK COUNTY,4013,6236,140,10389
2012,North Carolina,NC,RANDOLPH COUNTY,14773,45160,782,60715
2012,North Carolina,NC,RICHMOND COUNTY,9904,9332,181,19417
2012,North Carolina,NC,ROBESON COUNTY,24988,17510,448,42946
2012,North Carolina,NC,ROCKINGHAM COUNTY,16351,25227,442,42020
2012,North Carolina,NC,ROWAN COUNTY,22650,38775,887,62312
2012,North Carolina,NC,RUTHERFORD COUNTY,9374,18954,374,28702
2012,North Carolina,NC,SAMPSON COUNTY,11566,14422,186,26174
2012,North Carolina,NC,SCOTLAND COUNTY,8215,5831,110,14156
2012,North Carolina,NC,STANLY COUNTY,8431,19904,382,28717
2012,North Carolina,NC,STOKES COUNTY,6018,15237,364,21619
2012,North Carolina,NC,SURRY COUNTY,9112,19923,435,29470
2012,North Carolina,NC,SWAIN COUNTY,2618,2976,134,5728
2012,North Carolina,NC,TRANSYLVANIA COUNTY,6826,9634,303,16763
2012,North Carolina,NC,TYRRELL COUNTY,837,930,16,1783
2012,North Carolina,NC,UNION COUNTY,32473,61107,1148,94728
2012,North Carolina,NC,VANCE COUNTY,13323,7429,102,20854
2012,North Carolina,NC,WAKE COUNTY,267262,211596,7569,486427
2012,North Carolina,NC,WARREN COUNTY,6978,3140,44,10162
2012,North Carolina,NC,WASHINGTON COUNTY,3833,2622,44,6499
2012,North Carolina,NC,WATAUGA COUNTY,13002,13861,811,27674
2012,North Carolina,NC,WAYNE COUNTY,23314,27641,397,51352
2012,North Carolina,NC,WILKES COUNTY,8148,20515,482,29145
2012,North Carolina,NC,WILSON COUNTY,20875,17954,280,39109
2012,North Carolina,NC,YADKIN COUNTY,3957,12578,278,16813
2012,North Carolina,NC,YANCEY COUNTY,3981,5278,192,9451
2012,Ohio,OH,ADAMS COUNTY,3976,6865,248,11089
2012,Ohio,OH,ALLEN COUNTY,17913,29502,820,48235
2012,Ohio,OH,ASHLAND COUNTY,8281,15519,530,24330
2012,Ohio,OH,ASHTABULA COUNTY,23803,18298,963,43064
2012,Ohio,OH,ATHENS COUNTY,18307,8543,788,27638
2012,Ohio,OH,AUGLAIZE COUNTY,5831,17169,405,23405
2012,Ohio,OH,BELMONT COUNTY,14156,16758,650,31564
2012,Ohio,OH,BROWN COUNTY,7107,11916,369,19392
2012,Ohio,OH,BUTLER COUNTY,62388,105176,2627,170191
2012,Ohio,OH,CARROLL COUNTY,5543,7315,404,13262
2012,Ohio,OH,CHAMPAIGN COUNTY,7044,11045,332,18421
2012,Ohio,OH,CLARK COUNTY,31298,31816,1030,64144
2012,Ohio,OH,CLERMONT COUNTY,30458,64208,1607,96273
2012,Ohio,OH,CLINTON COUNTY,5791,12009,344,18144
2012,Ohio,OH,COLUMBIANA COUNTY,19821,25251,979,46051
2012,Ohio,OH,COSHOCTON COUNTY,6940,8390,409,15739
2012,Ohio,OH,CRAWFORD COUNTY,7507,11852,444,19803
2012,Ohio,OH,CUYAHOGA COUNTY,447232,190651,6398,644281
2012,Ohio,OH,DARKE COUNTY,6826,18108,467,25401
2012,Ohio,OH,DEFIANCE COUNTY,7732,10176,380,18288
2012,Ohio,OH,DELAWARE COUNTY,37292,60194,1275,98761
2012,Ohio,OH,ERIE COUNTY,21793,16952,660,39405
2012,Ohio,OH,FAIRFIELD COUNTY,29890,41034,1144,72068
2012,Ohio,OH,FAYETTE COUNTY,4249,6620,151,11020
2012,Ohio,OH,FRANKLIN COUNTY,346336,215987,8660,570983
2012,Ohio,OH,FULTON COUNTY,9073,11738,457,21268
2012,Ohio,OH,GALLIA COUNTY,4557,7750,288,12595
2012,Ohio,OH,GEAUGA COUNTY,19659,30589,749,50997
2012,Ohio,OH,GREENE COUNTY,32256,49819,1415,83490
2012,Ohio,OH,GUERNSEY COUNTY,7450,8993,371,16814
2012,Ohio,OH,HAMILTON COUNTY,219927,193326,5641,418894
2012,Ohio,OH,HANCOCK COUNTY,12564,22443,687,35694
2012,Ohio,OH,HARDIN COUNTY,4619,7489,341,12449
2012,Ohio,OH,HARRISON COUNTY,2950,4019,172,7141
2012,Ohio,OH,HENRY COUNTY,5658,8257,321,14236
2012,Ohio,OH,HIGHLAND COUNTY,6049,11410,380,17839
2012,Ohio,OH,HOCKING COUNTY,6157,6285,286,12728
2012,Ohio,OH,HOLMES COUNTY,2608,8702,226,11536
2012,Ohio,OH,HURON COUNTY,11006,13060,597,24663
2012,Ohio,OH,JACKSON COUNTY,5166,7904,311,13381
2012,Ohio,OH,JEFFERSON COUNTY,15385,17034,650,33069
2012,Ohio,OH,KNOX COUNTY,10470,17266,652,28388
2012,Ohio,OH,LAKE COUNTY,57680,58744,1980,118404
2012,Ohio,OH,LAWRENCE COUNTY,10744,14651,438,25833
2012,Ohio,OH,LICKING COUNTY,34201,45503,1686,81390
2012,Ohio,OH,LOGAN COUNTY,7062,13633,442,21137
2012,Ohio,OH,LORAIN COUNTY,81464,59405,2384,143253
2012,Ohio,OH,LUCAS COUNTY,136616,69940,3662,210218
2012,Ohio,OH,MADISON COUNTY,6845,10342,330,17517
2012,Ohio,OH,MAHONING COUNTY,77059,42641,1610,121310
2012,Ohio,OH,MARION COUNTY,12504,14265,583,27352
2012,Ohio,OH,MEDINA COUNTY,38785,50418,1580,90783
2012,Ohio,OH,MEIGS COUNTY,4027,5895,296,10218
2012,Ohio,OH,MERCER COUNTY,4745,16561,355,21661
2012,Ohio,OH,MIAMI COUNTY,16383,34606,947,51936
2012,Ohio,OH,MONROE COUNTY,3035,3548,199,6782
2012,Ohio,OH,MONTGOMERY COUNTY,137139,124841,4298,266278
2012,Ohio,OH,MORGAN COUNTY,2814,3179,136,6129
2012,Ohio,OH,MORROW COUNTY,5933,9865,386,16184
2012,Ohio,OH,MUSKINGUM COUNTY,17001,19264,820,37085
2012,Ohio,OH,NOBLE COUNTY,2131,3563,178,5872
2012,Ohio,OH,OTTAWA COUNTY,11503,10538,415,22456
2012,Ohio,OH,PAULDING COUNTY,3538,5354,236,9128
2012,Ohio,OH,PERRY COUNTY,7033,7627,324,14984
2012,Ohio,OH,PICKAWAY COUNTY,9684,14037,402,24123
2012,Ohio,OH,PIKE COUNTY,5684,5685,212,11581
2012,Ohio,OH,PORTAGE COUNTY,39453,35242,1544,76239
2012,Ohio,OH,PREBLE COUNTY,6211,13535,423,20169
2012,Ohio,OH,PUTNAM COUNTY,4318,13721,333,18372
2012,Ohio,OH,RICHLAND COUNTY,22687,33867,1161,57715
2012,Ohio,OH,ROSS COUNTY,14569,15008,506,30083
2012,Ohio,OH,SANDUSKY COUNTY,14541,13755,698,28994
2012,Ohio,OH,SCIOTO COUNTY,15077,15492,592,31161
2012,Ohio,OH,SENECA COUNTY,11353,13243,666,25262
2012,Ohio,OH,SHELBY COUNTY,6343,17142,381,23866
2012,Ohio,OH,STARK COUNTY,89432,88581,3464,181477
2012,Ohio,OH,SUMMIT COUNTY,153037,111000,3674,267711
2012,Ohio,OH,TRUMBULL COUNTY,61672,38279,1768,101719
2012,Ohio,OH,TUSCARAWAS COUNTY,18407,22242,964,41613
2012,Ohio,OH,UNION COUNTY,8805,16289,473,25567
2012,Ohio,OH,VAN WERT COUNTY,4029,9585,252,13866
2012,Ohio,OH,VINTON COUNTY,2436,2856,175,5467
2012,Ohio,OH,WARREN COUNTY,32909,76561,1534,111004
2012,Ohio,OH,WASHINGTON COUNTY,11651,17284,564,29499
2012,Ohio,OH,WAYNE COUNTY,19808,30251,1005,51064
2012,Ohio,OH,WILLIAMS COUNTY,7266,10047,393,17706
2012,Ohio,OH,WOOD COUNTY,32802,29704,1442,63948
2012,Ohio,OH,WYANDOT COUNTY,4137,6180,255,10572
2012,Pennsylvania,PA,ADAMS COUNTY,15091,26767,599,42457
2012,Pennsylvania,PA,ALLEGHENY COUNTY,352687,262039,7355,622081
2012,Pennsylvania,PA,ARMSTRONG COUNTY,9045,20142,415,29602
2012,Pennsylvania,PA,BEAVER COUNTY,37055,42344,1075,80474
2012,Pennsylvania,PA,BEDFORD COUNTY,4788,16702,207,21697
2012,Pennsylvania,PA,BERKS COUNTY,83011,84702,2607,170320
2012,Pennsylvania,PA,BLAIR COUNTY,16276,33319,646,50241
2012,Pennsylvania,PA,BRADFORD COUNTY,8624,14410,392,23426
2012,Pennsylvania,PA,BUCKS COUNTY,160521,156579,3916,321016
2012,Pennsylvania,PA,BUTLER COUNTY,28550,59761,1134,89445
2012,Pennsylvania,PA,CAMBRIA COUNTY,24249,35163,1114,60526
2012,Pennsylvania,PA,CAMERON COUNTY,724,1359,28,2111
2012,Pennsylvania,PA,CARBON COUNTY,11580,13504,497,25581
2012,Pennsylvania,PA,CENTRE COUNTY,34176,34001,1449,69626
2012,Pennsylvania,PA,CHESTER COUNTY,124311,124840,2822,251973
2012,Pennsylvania,PA,CLARION COUNTY,5056,10828,302,16186
2012,Pennsylvania,PA,CLEARFIELD COUNTY,11121,20347,499,31967
2012,Pennsylvania,PA,CLINTON COUNTY,5734,7303,228,13265
2012,Pennsylvania,PA,COLUMBIA COUNTY,10937,14236,450,25623
2012,Pennsylvania,PA,CRAWFORD COUNTY,13883,20901,604,35388
2012,Pennsylvania,PA,CUMBERLAND COUNTY,44367,64809,1638,110814
2012,Pennsylvania,PA,DAUPHIN COUNTY,64965,57450,1593,124008
2012,Pennsylvania,PA,DELAWARE COUNTY,171792,110853,2919,285564
2012,Pennsylvania,PA,ELK COUNTY,5463,7579,196,13238
2012,Pennsylvania,PA,ERIE COUNTY,68036,49025,1558,118619
2012,Pennsylvania,PA,FAYETTE COUNTY,21971,26018,516,48505
2012,Pennsylvania,PA,FOREST COUNTY,896,1383,33,2312
2012,Pennsylvania,PA,FRANKLIN COUNTY,18995,43260,823,63078
2012,Pennsylvania,PA,FULTON COUNTY,1310,4814,71,6195
2012,Pennsylvania,PA,GREENE COUNTY,5852,8428,184,14464
2012,Pennsylvania,PA,HUNTINGDON COUNTY,5409,11979,251,17639
2012,Pennsylvania,PA,INDIANA COUNTY,14473,21257,591,36321
2012,Pennsylvania,PA,JEFFERSON COUNTY,4787,13048,262,18097
2012,Pennsylvania,PA,JUNIATA COUNTY,2547,6862,126,9535
2012,Pennsylvania,PA,LACKAWANNA COUNTY,61838,35085,1092,98015
2012,Pennsylvania,PA,LANCASTER COUNTY,88481,130669,3286,222436
2012,Pennsylvania,PA,LAWRENCE COUNTY,17513,21047,476,39036
2012,Pennsylvania,PA,LEBANON COUNTY,19900,35872,808,56580
2012,Pennsylvania,PA,LEHIGH COUNTY,78283,66874,1845,147002
2012,Pennsylvania,PA,LUZERNE COUNTY,64307,58325,1807,124439
2012,Pennsylvania,PA,LYCOMING COUNTY,15203,30658,632,46493
2012,Pennsylvania,PA,MCKEAN COUNTY,5297,9545,266,15108
2012,Pennsylvania,PA,MERCER COUNTY,24232,25925,706,50863
2012,Pennsylvania,PA,MIFFLIN COUNTY,4273,11939,159,16371
2012,Pennsylvania,PA,MONROE COUNTY,35221,26867,829,62917
2012,Pennsylvania,PA,MONTGOMERY COUNTY,233356,174381,4463,412200
2012,Pennsylvania,PA,MONTOUR COUNTY,3053,4652,126,7831
2012,Pennsylvania,PA,NORTHAMPTON COUNTY,67606,61446,1683,130735
2012,Pennsylvania,PA,NORTHUMBERLAND COUNTY,13072,19518,622,33212
2012,Pennsylvania,PA,PERRY COUNTY,5685,13120,323,19128
2012,Pennsylvania,PA,PHILADELPHIA COUNTY,588806,96467,5054,690327
2012,Pennsylvania,PA,PIKE COUNTY,10210,12786,283,23279
2012,Pennsylvania,PA,POTTER COUNTY,1897,5231,114,7242
2012,Pennsylvania,PA,SCHUYLKILL COUNTY,24546,32278,903,57727
2012,Pennsylvania,PA,SNYDER COUNTY,4687,10073,242,15002
2012,Pennsylvania,PA,SOMERSET COUNTY,9436,23984,522,33942
2012,Pennsylvania,PA,SULLIVAN COUNTY,1034,1868,47,2949
2012,Pennsylvania,PA,SUSQUEHANNA COUNTY,6935,10800,309,18044
2012,Pennsylvania,PA,TIOGA COUNTY,5357,11342,305,17004
2012,Pennsylvania,PA,UNION COUNTY,6109,9896,263,16268
2012,Pennsylvania,PA,VENANGO COUNTY,7945,13815,407,22167
2012,Pennsylvania,PA,WARREN COUNTY,6995,10010,294,17299
2012,Pennsylvania,PA,WASHINGTON COUNTY,40345,53230,1175,94750
2012,Pennsylvania,PA,WAYNE COUNTY,8396,12896,315,21607
2012,Pennsylvania,PA,WESTMORELAND COUNTY,63722,103932,1918,169572
2012,Pennsylvania,PA,WYOMING COUNTY,5061,6587,224,11872
2012,Pennsylvania,PA,YORK COUNTY,73191,113304,2734,189229
2012,Wisconsin,WI,ADAMS COUNTY,5542,4644,101,10287
2012,Wisconsin,WI,ASHLAND COUNTY,5399,2820,153,8372
2012,Wisconsin,WI,BARRON COUNTY,10890,11443,359,22692
2012,Wisconsin,WI,BAYFIELD COUNTY,6033,3603,152,9788
2012,Wisconsin,WI,BROWN COUNTY,62526,64836,1566,128928
2012,Wisconsin,WI,BUFFALO COUNTY,3570,3364,105,7039
2012,Wisconsin,WI,BURNETT COUNTY,3986,4550,141,8677
2012,Wisconsin,WI,CALUMET COUNTY,11489,14539,392,26420
2012,Wisconsin,WI,CHIPPEWA COUNTY,15237,15322,373,30932
2012,Wisconsin,WI,CLARK COUNTY,6172,7412,217,13801
2012,Wisconsin,WI,COLUMBIA COUNTY,17175,13026,345,30546
2012,Wisconsin,WI,CRAWFORD COUNTY,4629,3067,121,7817
2012,Wisconsin,WI,DANE COUNTY,216071,83644,4466,304181
2012,Wisconsin,WI,DODGE COUNTY,18762,25211,515,44488
2012,Wisconsin,WI,DOOR COUNTY,9357,8121,193,17671
2012,Wisconsin,WI,DOUGLAS COUNTY,14863,7705,326,22894
2012,Wisconsin,WI,DUNN COUNTY,11316,10224,452,21992
2012,Wisconsin,WI,EAU CLAIRE COUNTY,30666,23256,884,54806
2012,Wisconsin,WI,FLORENCE COUNTY,953,1645,27,2625
2012,Wisconsin,WI,FOND DU LAC COUNTY,22379,30355,668,53402
2012,Wisconsin,WI,FOREST COUNTY,2425,2172,51,4648
2012,Wisconsin,WI,GRANT COUNTY,13594,10255,399,24248
2012,Wisconsin,WI,GREEN COUNTY,11206,7857,259,19322
2012,Wisconsin,WI,GREEN LAKE COUNTY,3793,5782,100,9675
2012,Wisconsin,WI,IOWA COUNTY,8105,4287,142,12534
2012,Wisconsin,WI,IRON COUNTY,1784,1790,58,3632
2012,Wisconsin,WI,JACKSON COUNTY,5298,3900,115,9313
2012,Wisconsin,WI,JEFFERSON COUNTY,20158,23517,606,44281
2012,Wisconsin,WI,JUNEAU COUNTY,6242,5411,174,11827
2012,Wisconsin,WI,KENOSHA COUNTY,44867,34977,1053,80897
2012,Wisconsin,WI,KEWAUNEE COUNTY,5153,5747,137,11037
2012,Wisconsin,WI,LA CROSSE COUNTY,36693,25751,1018,63462
2012,Wisconsin,WI,LAFAYETTE COUNTY,4536,3314,102,7952
2012,Wisconsin,WI,LANGLADE COUNTY,4573,5816,130,10519
2012,Wisconsin,WI,LINCOLN COUNTY,7563,7455,198,15216
2012,Wisconsin,WI,MANITOWOC COUNTY,20403,21604,610,42617
2012,Wisconsin,WI,MARATHON COUNTY,32363,36617,882,69862
2012,Wisconsin,WI,MARINETTE COUNTY,9882,10619,276,20777
2012,Wisconsin,WI,MARQUETTE COUNTY,4014,3992,99,8105
2012,Wisconsin,WI,MENOMINEE COUNTY,1191,179,7,1377
2012,Wisconsin,WI,MILWAUKEE COUNTY,332438,154924,5214,492576
2012,Wisconsin,WI,MONROE COUNTY,9515,9675,295,19485
2012,Wisconsin,WI,OCONTO COUNTY,8865,10741,253,19859
2012,Wisconsin,WI,ONEIDA COUNTY,10452,10917,283,21652
2012,Wisconsin,WI,OUTAGAMIE COUNTY,45659,47372,1565,94596
2012,Wisconsin,WI,OZAUKEE COUNTY,19159,36077,581,55817
2012,Wisconsin,WI,PEPIN COUNTY,1876,1794,29,3699
2012,Wisconsin,WI,PIERCE COUNTY,10235,10397,388,21020
2012,Wisconsin,WI,POLK COUNTY,10073,12094,406,22573
2012,Wisconsin,WI,PORTAGE COUNTY,22075,16615,647,39337
2012,Wisconsin,WI,PRICE COUNTY,3887,3884,130,7901
2012,Wisconsin,WI,RACINE COUNTY,53008,49347,1009,103364
2012,Wisconsin,WI,RICHLAND COUNTY,4969,3573,113,8655
2012,Wisconsin,WI,ROCK COUNTY,49219,30517,954,80690
2012,Wisconsin,WI,RUSK COUNTY,3397,3676,118,7191
2012,Wisconsin,WI,ST. CROIX COUNTY,19910,25503,812,46225
2012,Wisconsin,WI,SAUK COUNTY,18736,12838,353,31927
2012,Wisconsin,WI,SAWYER COUNTY,4486,4442,97,9025
2012,Wisconsin,WI,SHAWANO COUNTY,9000,11022,257,20279
2012,Wisconsin,WI,SHEBOYGAN COUNTY,27918,34072,661,62651
2012,Wisconsin,WI,TAYLOR COUNTY,3763,5601,148,9512
2012,Wisconsin,WI,TREMPEALEAU COUNTY,7605,5707,169,13481
2012,Wisconsin,WI,VERNON COUNTY,8044,5942,283,14269
2012,Wisconsin,WI,VILAS COUNTY,5951,7749,142,13842
2012,Wisconsin,WI,WALWORTH COUNTY,22552,29006,745,52303
2012,Wisconsin,WI,WASHBURN COUNTY,4447,4699,141,9287
2012,Wisconsin,WI,WASHINGTON COUNTY,23166,54765,811,78742
2012,Wisconsin,WI,WAUKESHA COUNTY,78779,162798,2279,243856
2012,Wisconsin,WI,WAUPACA COUNTY,11578,17002,260,28840
2012,Wisconsin,WI,WAUSHARA COUNTY,5335,6562,151,12048
2012,Wisconsin,WI,WINNEBAGO COUNTY,45449,42122,1602,89173
2012,Wisconsin,WI,WOOD COUNTY,18581,19704,615,38900
2016,Arizona,AZ,APACHE COUNTY,17083,8240,2338,27661
2016,Arizona,AZ,COCHISE COUNTY,17450,28092,4473,50015
2016,Arizona,AZ,COCONINO COUNTY,32404,21108,6272,59784
2016,Arizona,AZ,GILA COUNTY,7003,14182,1127,22312
2016,Arizona,AZ,GRAHAM COUNTY,3301,8025,808,12134
2016,Arizona,AZ,GREENLEE COUNTY,1092,1892,286,3270
2016,Arizona,AZ,LA PAZ COUNTY,1575,4003,373,5951
2016,Arizona,AZ,MARICOPA COUNTY,702907,747361,117566,1567834
2016,Arizona,AZ,MOHAVE COUNTY,17455,58282,4206,79943
2016,Arizona,AZ,NAVAJO COUNTY,16459,20577,3258,40294
2016,Arizona,AZ,PIMA COUNTY,224661,167428,29551,421640
2016,Arizona,AZ,PINAL COUNTY,47892,72819,8835,129546
2016,Arizona,AZ,SANTA CRUZ COUNTY,11690,3897,846,16433
2016,Arizona,AZ,YAVAPAI COUNTY,35590,71330,7530,114450
2016,Arizona,AZ,YUMA COUNTY,24605,25165,3240,53010
2016,Florida,FL,ALACHUA COUNTY,75820,46834,5917,128571
2016,Florida,FL,BAKER COUNTY,2112,10294,228,12634
2016,Florida,FL,BAY COUNTY,21797,62194,3462,87453
2016,Florida,FL,BRADFORD COUNTY,2924,8913,261,12098
2016,Florida,FL,BREVARD COUNTY,119679,181848,13225,314752
2016,Florida,FL,BROWARD COUNTY,553320,260951,17680,831951
2016,Florida,FL,CALHOUN COUNTY,1241,4655,185,6081
2016,Florida,FL,CHARLOTTE COUNTY,33445,60218,2711,96374
2016,Florida,FL,CITRUS COUNTY,22789,54456,2455,79700
2016,Florida,FL,CLAY COUNTY,27822,74963,3698,106483
2016,Florida,FL,COLLIER COUNTY,61085,105423,4281,170789
2016,Florida,FL,COLUMBIA COUNTY,7601,20368,738,28707
2016,Florida,FL,DESOTO COUNTY,3781,6778,259,10818
2016,Florida,FL,DIXIE COUNTY,1270,5822,110,7202
2016,Florida,FL,DUVAL COUNTY,205704,211672,15319,432695
2016,Florida,FL,ESCAMBIA COUNTY,57461,88808,6200,152469
2016,Florida,FL,FLAGLER COUNTY,22026,33850,1627,57503
2016,Florida,FL,FRANKLIN COUNTY,1744,4125,146,6015
2016,Florida,FL,GADSDEN COUNTY,15020,6728,365,22113
2016,Florida,FL,GILCHRIST COUNTY,1458,6740,222,8420
2016,Florida,FL,GLADES COUNTY,1271,2996,86,4353
2016,Florida,FL,GULF COUNTY,1720,5329,244,7293
2016,Florida,FL,HAMILTON COUNTY,1904,3443,113,5460
2016,Florida,FL,HARDEE COUNTY,2149,5242,192,7583
2016,Florida,FL,HENDRY COUNTY,4615,6195,305,11115
2016,Florida,FL,HERNANDO COUNTY,31795,58970,3031,93796
2016,Florida,FL,HIGHLANDS COUNTY,14937,29565,1184,45686
2016,Florida,FL,HILLSBOROUGH COUNTY,307896,266870,22894,597660
2016,Florida,FL,HOLMES COUNTY,853,7483,178,8514
2016,Florida,FL,INDIAN RIVER COUNTY,29043,48620,2346,80009
2016,Florida,FL,JACKSON COUNTY,6397,14257,387,21041
2016,Florida,FL,JEFFERSON COUNTY,3541,3930,174,7645
2016,Florida,FL,LAFAYETTE COUNTY,518,2809,65,3392
2016,Florida,FL,LAKE COUNTY,62838,102188,5436,170462
2016,Florida,FL,LEE COUNTY,124908,191551,9961,326420
2016,Florida,FL,LEON COUNTY,92068,53821,6243,152132
2016,Florida,FL,LEVY COUNTY,5101,13775,519,19395
2016,Florida,FL,LIBERTY COUNTY,651,2543,102,3296
2016,Florida,FL,MADISON COUNTY,3526,4851,128,8505
2016,Florida,FL,MANATEE COUNTY,71224,101944,5790,178958
2016,Florida,FL,MARION COUNTY,62041,107833,4826,174700
2016,Florida,FL,MARTIN COUNTY,30185,53204,2403,85792
2016,Florida,FL,MIAMI-DADE COUNTY,624146,333999,22059,980204
2016,Florida,FL,MONROE COUNTY,18971,21904,1603,42478
2016,Florida,FL,NASSAU COUNTY,10869,34266,1472,46607
2016,Florida,FL,OKALOOSA COUNTY,23780,71893,5182,100855
2016,Florida,FL,OKEECHOBEE COUNTY,3959,9356,338,13653
2016,Florida,FL,ORANGE COUNTY,329894,195216,21165,546275
2016,Florida,FL,OSCEOLA COUNTY,85458,50301,4447,140206
2016,Florida,FL,PALM BEACH COUNTY,374673,272402,15257,662332
2016,Florida,FL,PASCO COUNTY,90142,142101,8896,241139
2016,Florida,FL,PINELLAS COUNTY,233701,239201,19501,492403
2016,Florida,FL,POLK COUNTY,117433,157430,9451,284314
2016,Florida,FL,PUTNAM COUNTY,10094,22138,885,33117
2016,Florida,FL,ST. JOHNS COUNTY,43099,88684,4731,136514
2016,Florida,FL,ST. LUCIE COUNTY,66881,70289,3677,140847
2016,Florida,FL,SANTA ROSA COUNTY,18464,65339,3942,87745
2016,Florida,FL,SARASOTA COUNTY,97870,124438,6755,229063
2016,Florida,FL,SEMINOLE COUNTY,105914,109443,9539,224896
2016,Florida,FL,SUMTER COUNTY,22638,52730,1297,76665
2016,Florida,FL,SUWANNEE COUNTY,3964,14287,443,18694
2016,Florida,FL,TAYLOR COUNTY,2152,6930,208,9290
2016,Florida,FL,UNION COUNTY,1014,4568,112,5694
2016,Florida,FL,VOLUSIA COUNTY,109091,143007,8771,260869
2016,Florida,FL,WAKULLA COUNTY,4348,10512,491,15351
2016,Florida,FL,WALTON COUNTY,6876,25756,1005,33637
2016,Florida,FL,WASHINGTON COUNTY,2264,8637,255,11156
2016,Georgia,GA,APPLING COUNTY,1434,5494,84,7012
2016,Georgia,GA,ATKINSON COUNTY,697,1878,35,2610
2016,Georgia,GA,BACON COUNTY,608,3364,48,4020
2016,Georgia,GA,BAKER COUNTY,650,775,15,1440
2016,Georgia,GA,BALDWIN COUNTY,7970,7697,449,16116
2016,Georgia,GA,BANKS COUNTY,684,6134,157,6975
2016,Georgia,GA,BARROW COUNTY,6580,21108,1372,29060
2016,Georgia,GA,BARTOW COUNTY,8212,29911,1427,39550
2016,Georgia,GA,BEN HILL COUNTY,2101,3739,96,5936
2016,Georgia,GA,BERRIEN COUNTY,1047,5422,121,6590
2016,Georgia,GA,BIBB COUNTY,36787,24043,1766,62596
2016,Georgia,GA,BLECKLEY COUNTY,1101,3719,154,4974
2016,Georgia,GA,BRANTLEY COUNTY,619,5567,115,6301
2016,Georgia,GA,BROOKS COUNTY,2528,3701,107,6336
2016,Georgia,GA,BRYAN COUNTY,4014,10529,630,15173
2016,Georgia,GA,BULLOCH COUNTY,9261,15097,958,25316
2016,Georgia,GA,BURKE COUNTY,4731,4491,129,9351
2016,Georgia,GA,BUTTS COUNTY,2566,6717,231,9514
2016,Georgia,GA,CALHOUN COUNTY,1179,830,16,2025
2016,Georgia,GA,CAMDEN COUNTY,5930,12310,661,18901
2016,Georgia,GA,CANDLER COUNTY,1026,2664,73,3763
2016,Georgia,GA,CARROLL COUNTY,12464,30029,1628,44121
2016,Georgia,GA,CATOOSA COUNTY,4771,20876,1110,26757
2016,Georgia,GA,CHARLTON COUNTY,1004,2951,61,4016
2016,Georgia,GA,CHATHAM COUNTY,62290,45688,4164,112142
2016,Georgia,GA,CHATTAHOOCHEE COUNTY,594,751,45,1390
2016,Georgia,GA,CHATTOOGA COUNTY,1613,6462,177,8252
2016,Georgia,GA,CHEROKEE COUNTY,25231,80649,6163,112043
2016,Georgia,GA,CLARKE COUNTY,29603,12717,2656,44976
2016,Georgia,GA,CLAY COUNTY,697,566,10,1273
2016,Georgia,GA,CLAYTON COUNTY,78220,12645,1994,92859
2016,Georgia,GA,CLINCH COUNTY,686,1727,42,2455
2016,Georgia,GA,COBB COUNTY,160121,152912,17786,330819
2016,Georgia,GA,COFFEE COUNTY,4094,9588,233,13915
2016,Georgia,GA,COLQUITT COUNTY,3463,9898,263,13624
2016,Georgia,GA,COLUMBIA COUNTY,18887,43085,2771,64743
2016,Georgia,GA,COOK COUNTY,1753,4176,128,6057
2016,Georgia,GA,COWETA COUNTY,16583,42533,2629,61745
2016,Georgia,GA,CRAWFORD COUNTY,1421,3635,120,5176
2016,Georgia,GA,CRISP COUNTY,2837,4549,126,7512
2016,Georgia,GA,DADE COUNTY,965,5051,226,6242
2016,Georgia,GA,DAWSON COUNTY,1448,9900,417,11765
2016,Georgia,GA,DECATUR COUNTY,4124,6020,142,10286
2016,Georgia,GA,DEKALB COUNTY,251370,51468,11919,314757
2016,Georgia,GA,DODGE COUNTY,1839,5021,149,7009
2016,Georgia,GA,DOOLY COUNTY,1872,1951,36,3859
2016,Georgia,GA,DOUGHERTY COUNTY,23311,10232,544,34087
2016,Georgia,GA,DOUGLAS COUNTY,31005,24817,1916,57738
2016,Georgia,GA,EARLY COUNTY,2168,2552,65,4785
2016,Georgia,GA,ECHOLS COUNTY,156,1007,19,1182
2016,Georgia,GA,EFFINGHAM COUNTY,4853,17874,731,23458
2016,Georgia,GA,ELBERT COUNTY,2539,5292,156,7987
2016,Georgia,GA,EMANUEL COUNTY,2435,5335,90,7860
2016,Georgia,GA,EVANS COUNTY,1130,2404,79,3613
2016,Georgia,GA,FANNIN COUNTY,1923,9632,257,11812
2016,Georgia,GA,FAYETTE COUNTY,23284,35048,2581,60913
2016,Georgia,GA,FLOYD COUNTY,9159,24114,1335,34608
2016,Georgia,GA,FORSYTH COUNTY,23462,69851,4908,98221
2016,Georgia,GA,FRANKLIN COUNTY,1243,7054,205,8502
2016,Georgia,GA,FULTON COUNTY,297051,117783,16557,431391
2016,Georgia,GA,GILMER COUNTY,1965,10477,331,12773
2016,Georgia,GA,GLASCOCK COUNTY,138,1235,17,1390
2016,Georgia,GA,GLYNN COUNTY,11775,21512,976,34263
2016,Georgia,GA,GORDON COUNTY,3181,15191,587,18959
2016,Georgia,GA,GRADY COUNTY,3013,6053,147,9213
2016,Georgia,GA,GREENE COUNTY,3199,5490,163,8852
2016,Georgia,GA,GWINNETT COUNTY,166153,146989,15189,328331
2016,Georgia,GA,HABERSHAM COUNTY,2483,13190,570,16243
2016,Georgia,GA,HALL COUNTY,16180,51733,2781,70694
2016,Georgia,GA,HANCOCK COUNTY,2701,843,36,3580
2016,Georgia,GA,HARALSON COUNTY,1475,9585,297,11357
2016,Georgia,GA,HARRIS COUNTY,4086,11936,480,16502
2016,Georgia,GA,HART COUNTY,2585,7286,246,10117
2016,Georgia,GA,HEARD COUNTY,743,3370,110,4223
2016,Georgia,GA,HENRY COUNTY,50057,45724,2985,98766
2016,Georgia,GA,HOUSTON COUNTY,22553,35430,2096,60079
2016,Georgia,GA,IRWIN COUNTY,891,2716,63,3670
2016,Georgia,GA,JACKSON COUNTY,4491,21784,915,27190
2016,Georgia,GA,JASPER COUNTY,1544,4360,141,6045
2016,Georgia,GA,JEFF DAVIS COUNTY,901,4104,91,5096
2016,Georgia,GA,JEFFERSON COUNTY,3821,3063,84,6968
2016,Georgia,GA,JENKINS COUNTY,1123,1895,38,3056
2016,Georgia,GA,JOHNSON COUNTY,1136,2519,31,3686
2016,Georgia,GA,JONES COUNTY,3961,8305,285,12551
2016,Georgia,GA,LAMAR COUNTY,2270,5190,152,7612
2016,Georgia,GA,LANIER COUNTY,806,1984,81,2871
2016,Georgia,GA,LAURENS COUNTY,6752,12411,367,19530
2016,Georgia,GA,LEE COUNTY,3170,10646,327,14143
2016,Georgia,GA,LIBERTY COUNTY,9556,6134,453,16143
2016,Georgia,GA,LINCOLN COUNTY,1273,2759,70,4102
2016,Georgia,GA,LONG COUNTY,1360,2626,131,4117
2016,Georgia,GA,LOWNDES COUNTY,15064,21635,1106,37805
2016,Georgia,GA,LUMPKIN COUNTY,2220,9619,586,12425
2016,Georgia,GA,MCDUFFIE COUNTY,3699,5432,137,9268
2016,Georgia,GA,MCINTOSH COUNTY,2303,3487,113,5903
2016,Georgia,GA,MACON COUNTY,2705,1540,42,4287
2016,Georgia,GA,MADISON COUNTY,2425,9201,372,11998
2016,Georgia,GA,MARION COUNTY,1213,1921,56,3190
2016,Georgia,GA,MERIWETHER COUNTY,3804,5222,191,9217
2016,Georgia,GA,MILLER COUNTY,623,1891,30,2544
2016,Georgia,GA,MITCHELL COUNTY,3493,4279,108,7880
2016,Georgia,GA,MONROE COUNTY,3571,8832,284,12687
2016,Georgia,GA,MONTGOMERY COUNTY,847,2670,59,3576
2016,Georgia,GA,MORGAN COUNTY,2663,6559,253,9475
2016,Georgia,GA,MURRAY COUNTY,1800,10341,317,12458
2016,Georgia,GA,MUSCOGEE COUNTY,39851,26976,2205,69032
2016,Georgia,GA,NEWTON COUNTY,21943,20913,1131,43987
2016,Georgia,GA,OCONEE COUNTY,5581,13425,1143,20149
2016,Georgia,GA,OGLETHORPE COUNTY,1831,4625,218,6674
2016,Georgia,GA,PAULDING COUNTY,18025,44662,2203,64890
2016,Georgia,GA,PEACH COUNTY,5100,5413,239,10752
2016,Georgia,GA,PICKENS COUNTY,1979,11651,408,14038
2016,Georgia,GA,PIERCE COUNTY,903,6302,106,7311
2016,Georgia,GA,PIKE COUNTY,1240,7278,207,8725
2016,Georgia,GA,POLK COUNTY,2867,11014,334,14215
2016,Georgia,GA,PULASKI COUNTY,1104,2437,64,3605
2016,Georgia,GA,PUTNAM COUNTY,2758,6544,186,9488
2016,Georgia,GA,QUITMAN COUNTY,461,575,8,1044
2016,Georgia,GA,RABUN COUNTY,1444,6287,261,7992
2016,Georgia,GA,RANDOLPH COUNTY,1598,1271,30,2899
2016,Georgia,GA,RICHMOND COUNTY,48814,24461,2240,75515
2016,Georgia,GA,ROCKDALE COUNTY,23255,13478,1136,37869
2016,Georgia,GA,SCHLEY COUNTY,401,1472,36,1909
2016,Georgia,GA,SCREVEN COUNTY,2300,3305,110,5715
2016,Georgia,GA,SEMINOLE COUNTY,1189,2345,54,3588
2016,Georgia,GA,SPALDING COUNTY,9357,15646,701,25704
2016,Georgia,GA,STEPHENS COUNTY,1837,7686,292,9815
2016,Georgia,GA,STEWART COUNTY,1222,805,31,2058
2016,Georgia,GA,SUMTER COUNTY,5520,5276,178,10974
2016,Georgia,GA,TALBOT COUNTY,2002,1196,48,3246
2016,Georgia,GA,TALIAFERRO COUNTY,545,349,3,897
2016,Georgia,GA,TATTNALL COUNTY,1681,5096,126,6903
2016,Georgia,GA,TAYLOR COUNTY,1296,2064,48,3408
2016,Georgia,GA,TELFAIR COUNTY,1313,2450,33,3796
2016,Georgia,GA,TERRELL COUNTY,2267,1874,48,4189
2016,Georgia,GA,THOMAS COUNTY,7142,11228,432,18802
2016,Georgia,GA,TIFT COUNTY,4347,9584,288,14219
2016,Georgia,GA,TOOMBS COUNTY,2338,6615,185,9138
2016,Georgia,GA,TOWNS COUNTY,1210,5383,171,6764
2016,Georgia,GA,TREUTLEN COUNTY,862,1809,32,2703
2016,Georgia,GA,TROUP COUNTY,9713,15750,648,26111
2016,Georgia,GA,TURNER COUNTY,1246,2095,57,3398
2016,Georgia,GA,TWIGGS COUNTY,1971,2035,53,4059
2016,Georgia,GA,UNION COUNTY,1963,9852,248,12063
2016,Georgia,GA,UPSON COUNTY,3475,7292,167,10934
2016,Georgia,GA,WALKER COUNTY,4215,18950,791,23956
2016,Georgia,GA,WALTON COUNTY,8292,31125,1281,40698
2016,Georgia,GA,WARE COUNTY,3440,8513,231,12184
2016,Georgia,GA,WARREN COUNTY,1314,991,29,2334
2016,Georgia,GA,WASHINGTON COUNTY,4200,4149,112,8461
2016,Georgia,GA,WAYNE COUNTY,2041,8153,219,10413
2016,Georgia,GA,WEBSTER COUNTY,473,630,13,1116
2016,Georgia,GA,WHEELER COUNTY,646,1421,35,2102
2016,Georgia,GA,WHITE COUNTY,1674,9761,388,11823
2016,Georgia,GA,WHITFIELD COUNTY,7937,21537,1184,30658
2016,Georgia,GA,WILCOX COUNTY,852,2096,28,2976
2016,Georgia,GA,WILKES COUNTY,1848,2572,66,4486
2016,Georgia,GA,WILKINSON COUNTY,1894,2333,60,4287
2016,Georgia,GA,WORTH COUNTY,2020,6152,123,8295
2016,Michigan,MI,ALCONA COUNTY,1732,4201,265,6198
2016,Michigan,MI,ALGER COUNTY,1663,2585,270,4518
2016,Michigan,MI,ALLEGAN COUNTY,18050,34183,3553,55786
2016,Michigan,MI,ALPENA COUNTY,4877,9090,731,14698
2016,Michigan,MI,ANTRIM COUNTY,4448,8469,665,13582
2016,Michigan,MI,ARENAC COUNTY,2384,4950,362,7696
2016,Michigan,MI,BARAGA COUNTY,1156,2158,176,3490
2016,Michigan,MI,BARRY COUNTY,9114,19202,2013,30329
2016,Michigan,MI,BAY COUNTY,21642,28328,3007,52977
2016,Michigan,MI,BENZIE COUNTY,4108,5539,581,10228
2016,Michigan,MI,BERRIEN COUNTY,29495,38647,3889,72031
2016,Michigan,MI,BRANCH COUNTY,5061,11786,816,17663
2016,Michigan,MI,CALHOUN COUNTY,24157,31494,3251,58902
2016,Michigan,MI,CASS COUNTY,7270,14243,1082,22595
2016,Michigan,MI,CHARLEVOIX COUNTY,5137,8674,778,14589
2016,Michigan,MI,CHEBOYGAN COUNTY,4302,8683,687,13672
2016,Michigan,MI,CHIPPEWA COUNTY,5379,9122,955,15456
2016,Michigan,MI,CLARE COUNTY,4249,8505,635,13389
2016,Michigan,MI,CLINTON COUNTY,16492,21636,2527,40655
2016,Michigan,MI,CRAWFORD COUNTY,2110,4354,380,6844
2016,Michigan,MI,DELTA COUNTY,6436,11121,935,18492
2016,Michigan,MI,DICKINSON COUNTY,3923,8580,662,13165
2016,Michigan,MI,EATON COUNTY,24938,27609,3674,56221
2016,Michigan,MI,EMMET COUNTY,6972,10616,1214,18802
2016,Michigan,MI,GENESEE COUNTY,102751,84175,9370,196296
2016,Michigan,MI,GLADWIN COUNTY,3794,8124,554,12472
2016,Michigan,MI,GOGEBIC COUNTY,2925,4018,386,7329
2016,Michigan,MI,GRAND TRAVERSE COUNTY,20965,27413,3211,51589
2016,Michigan,MI,GRATIOT COUNTY,5666,9880,919,16465
2016,Michigan,MI,HILLSDALE COUNTY,4799,14095,1046,19940
2016,Michigan,MI,HOUGHTON COUNTY,6018,8475,1131,15624
2016,Michigan,MI,HURON COUNTY,4579,10692,646,15917
2016,Michigan,MI,INGHAM COUNTY,79110,43868,8160,131138
2016,Michigan,MI,IONIA COUNTY,8352,16635,1867,26854
2016,Michigan,MI,IOSCO COUNTY,4345,8345,671,13361
2016,Michigan,MI,IRON COUNTY,2004,3675,231,5910
2016,Michigan,MI,ISABELLA COUNTY,11404,12338,1650,25392
2016,Michigan,MI,JACKSON COUNTY,25795,39793,4089,69677
2016,Michigan,MI,KALAMAZOO COUNTY,67148,51034,8117,126299
2016,Michigan,MI,KALKASKA COUNTY,2280,6116,437,8833
2016,Michigan,MI,KENT COUNTY,138683,148180,21321,308184
2016,Michigan,MI,KEWEENAW COUNTY,527,814,93,1434
2016,Michigan,MI,LAKE COUNTY,1939,3159,230,5328
2016,Michigan,MI,LAPEER COUNTY,12734,30037,2412,45183
2016,Michigan,MI,LEELANAU COUNTY,6774,7239,744,14757
2016,Michigan,MI,LENAWEE COUNTY,16750,26430,2759,45939
2016,Michigan,MI,LIVINGSTON COUNTY,34384,65680,5802,105866
2016,Michigan,MI,LUCE COUNTY,681,1756,142,2579
2016,Michigan,MI,MACKINAC COUNTY,2085,3744,268,6097
2016,Michigan,MI,MACOMB COUNTY,176317,224665,18330,419312
2016,Michigan,MI,MANISTEE COUNTY,4979,6915,705,12599
2016,Michigan,MI,MARQUETTE COUNTY,16042,14646,2288,32976
2016,Michigan,MI,MASON COUNTY,5281,8505,899,14685
2016,Michigan,MI,MECOSTA COUNTY,5827,10305,1036,17168
2016,Michigan,MI,MENOMINEE COUNTY,3539,6702,527,10768
2016,Michigan,MI,MIDLAND COUNTY,15635,23846,3025,42506
2016,Michigan,MI,MISSAUKEE COUNTY,1565,5386,366,7317
2016,Michigan,MI,MONROE COUNTY,26863,43261,4094,74218
2016,Michigan,MI,MONTCALM COUNTY,7874,16907,1828,26609
2016,Michigan,MI,MONTMORENCY COUNTY,1287,3498,224,5009
2016,Michigan,MI,MUSKEGON COUNTY,37304,36127,4657,78088
2016,Michigan,MI,NEWAYGO COUNTY,6212,15173,1255,22640
2016,Michigan,MI,OAKLAND COUNTY,343070,289203,32341,664614
2016,Michigan,MI,OCEANA COUNTY,3973,7228,729,11930
2016,Michigan,MI,OGEMAW COUNTY,3030,6827,530,10387
2016,Michigan,MI,ONTONAGON COUNTY,1176,2066,184,3426
2016,Michigan,MI,OSCEOLA COUNTY,2705,7336,568,10609
2016,Michigan,MI,OSCODA COUNTY,1044,2843,186,4073
2016,Michigan,MI,OTSEGO COUNTY,3556,8266,716,12538
2016,Michigan,MI,OTTAWA COUNTY,44973,88467,9294,142734
2016,Michigan,MI,PRESQUE ISLE COUNTY,2400,4488,330,7218
2016,Michigan,MI,ROSCOMMON COUNTY,4287,8141,613,13041
2016,Michigan,MI,SAGINAW COUNTY,44396,45469,4455,94320
2016,Michigan,MI,ST. CLAIR COUNTY,24553,49051,4399,78003
2016,Michigan,MI,ST. JOSEPH COUNTY,7526,14884,1347,23757
2016,Michigan,MI,SANILAC COUNTY,4873,13446,930,19249
2016,Michigan,MI,SCHOOLCRAFT COUNTY,1369,2556,229,4154
2016,Michigan,MI,SHIAWASSEE COUNTY,12546,19230,2335,34111
2016,Michigan,MI,TUSCOLA COUNTY,7429,17102,1265,25796
2016,Michigan,MI,VAN BUREN COUNTY,13258,17890,2126,33274
2016,Michigan,MI,WASHTENAW COUNTY,128483,50631,9464,188578
2016,Michigan,MI,WAYNE COUNTY,519444,228993,29401,777838
2016,Michigan,MI,WEXFORD COUNTY,4436,10000,862,15298
2016,North Carolina,NC,ALAMANCE COUNTY,29833,38815,2509,71157
2016,North Carolina,NC,ALEXANDER COUNTY,3767,13893,611,18271
2016,North Carolina,NC,ALLEGHANY COUNTY,1306,3814,195,5315
2016,North Carolina,NC,ANSON COUNTY,5859,4506,180,10545
2016,North Carolina,NC,ASHE COUNTY,3500,9412,512,13424
2016,North Carolina,NC,AVERY COUNTY,1689,6298,262,8249
2016,North Carolina,NC,BEAUFORT COUNTY,8764,14543,631,23938
2016,North Carolina,NC,BERTIE COUNTY,5778,3456,113,9347
2016,North Carolina,NC,BLADEN COUNTY,7058,8550,289,15897
2016,North Carolina,NC,BRUNSWICK COUNTY,23282,42720,2349,68351
2016,North Carolina,NC,BUNCOMBE COUNTY,75452,55716,7779,138947
2016,North Carolina,NC,BURKE COUNTY,11251,26238,1431,38920
2016,North Carolina,NC,CABARRUS COUNTY,35521,53819,3949,93289
2016,North Carolina,NC,CALDWELL COUNTY,8425,26621,1274,36320
2016,North Carolina,NC,CAMDEN COUNTY,1274,3546,186,5006
2016,North Carolina,NC,CARTERET COUNTY,9939,26569,1273,37781
2016,North Carolina,NC,CASWELL COUNTY,4792,6026,252,11070
2016,North Carolina,NC,CATAWBA COUNTY,21216,48324,2811,72351
2016,North Carolina,NC,CHATHAM COUNTY,21065,17105,1679,39849
2016,North Carolina,NC,CHEROKEE COUNTY,2860,10844,477,14181
2016,North Carolina,NC,CHOWAN COUNTY,2992,4014,222,7228
2016,North Carolina,NC,CLAY COUNTY,1367,4437,206,6010
2016,North Carolina,NC,CLEVELAND COUNTY,14964,28479,1230,44673
2016,North Carolina,NC,COLUMBUS COUNTY,9063,14272,397,23732
2016,North Carolina,NC,CRAVEN COUNTY,17630,27731,1640,47001
2016,North Carolina,NC,CUMBERLAND COUNTY,71605,51265,4636,127506
2016,North Carolina,NC,CURRITUCK COUNTY,2913,9163,593,12669
2016,North Carolina,NC,DARE COUNTY,7222,11460,927,19609
2016,North Carolina,NC,DAVIDSON COUNTY,18109,54317,2430,74856
2016,North Carolina,NC,DAVIE COUNTY,5270,15602,884,21756
2016,North Carolina,NC,DUPLIN COUNTY,8283,12217,356,20856
2016,North Carolina,NC,DURHAM COUNTY,121250,28350,6534,156134
2016,North Carolina,NC,EDGECOMBE COUNTY,16224,8261,401,24886
2016,North Carolina,NC,FORSYTH COUNTY,94464,75975,7873,178312
2016,North Carolina,NC,FRANKLIN COUNTY,12874,16368,1126,30368
2016,North Carolina,NC,GASTON COUNTY,31177,61798,3456,96431
2016,North Carolina,NC,GATES COUNTY,2385,2874,133,5392
2016,North Carolina,NC,GRAHAM COUNTY,768,3283,117,4168
2016,North Carolina,NC,GRANVILLE COUNTY,12909,13591,853,27353
2016,North Carolina,NC,GREENE COUNTY,3605,4374,116,8095
2016,North Carolina,NC,GUILFORD COUNTY,149248,98062,10095,257405
2016,North Carolina,NC,HALIFAX COUNTY,15748,9031,388,25167
2016,North Carolina,NC,HARNETT COUNTY,16737,27614,1714,46065
2016,North Carolina,NC,HAYWOOD COUNTY,10473,18929,1325,30727
2016,North Carolina,NC,HENDERSON COUNTY,19827,35809,2540,58176
2016,North Carolina,NC,HERTFORD COUNTY,6910,3099,177,10186
2016,North Carolina,NC,HOKE COUNTY,9726,7760,744,18230
2016,North Carolina,NC,HYDE COUNTY,965,1288,51,2304
2016,North Carolina,NC,IREDELL COUNTY,24734,54754,3079,82567
2016,North Carolina,NC,JACKSON COUNTY,7713,9870,1130,18713
2016,North Carolina,NC,JOHNSTON COUNTY,28362,54372,3175,85909
2016,North Carolina,NC,JONES COUNTY,2065,2974,96,5135
2016,North Carolina,NC,LEE COUNTY,10469,13712,903,25084
2016,North Carolina,NC,LENOIR COUNTY,12634,13613,560,26807
2016,North Carolina,NC,LINCOLN COUNTY,9897,28806,1320,40023
2016,North Carolina,NC,MCDOWELL COUNTY,4667,14568,640,19875
2016,North Carolina,NC,MACON COUNTY,4876,12127,731,17734
2016,North Carolina,NC,MADISON COUNTY,3926,6783,560,11269
2016,North Carolina,NC,MARTIN COUNTY,5846,5897,221,11964
2016,North Carolina,NC,MECKLENBURG COUNTY,294562,155518,22777,472857
2016,North Carolina,NC,MITCHELL COUNTY,1596,6282,218,8096
2016,North Carolina,NC,MONTGOMERY COUNTY,4150,7130,260,11540
2016,North Carolina,NC,MOORE COUNTY,16329,30490,1873,48692
2016,North Carolina,NC,NASH COUNTY,23235,23319,1111,47665
2016,North Carolina,NC,NEW HANOVER COUNTY,50979,55344,5582,111905
2016,North Carolina,NC,NORTHAMPTON COUNTY,6144,3582,122,9848
2016,North Carolina,NC,ONSLOW COUNTY,17514,37122,2499,57135
2016,North Carolina,NC,ORANGE COUNTY,59923,18557,3860,82340
2016,North Carolina,NC,PAMLICO COUNTY,2448,4258,164,6870
2016,North Carolina,NC,PASQUOTANK COUNTY,8615,8180,596,17391
2016,North Carolina,NC,PENDER COUNTY,9354,17639,892,27885
2016,North Carolina,NC,PERQUIMANS COUNTY,2319,4177,212,6708
2016,North Carolina,NC,PERSON COUNTY,7833,11185,597,19615
2016,North Carolina,NC,PITT COUNTY,41824,35691,3012,80527
2016,North Carolina,NC,POLK COUNTY,3735,6768,431,10934
2016,North Carolina,NC,RANDOLPH COUNTY,13194,49430,1951,64575
2016,North Carolina,NC,RICHMOND COUNTY,8501,10383,444,19328
2016,North Carolina,NC,ROBESON COUNTY,19016,20762,1080,40858
2016,North Carolina,NC,ROCKINGHAM COUNTY,14228,26830,1220,42278
2016,North Carolina,NC,ROWAN COUNTY,19400,42810,2159,64369
2016,North Carolina,NC,RUTHERFORD COUNTY,7512,21871,924,30307
2016,North Carolina,NC,SAMPSON COUNTY,10547,14838,543,25928
2016,North Carolina,NC,SCOTLAND COUNTY,7319,6256,353,13928
2016,North Carolina,NC,STANLY COUNTY,7094,21964,859,29917
2016,North Carolina,NC,STOKES COUNTY,4665,17116,769,22550
2016,North Carolina,NC,SURRY COUNTY,7488,23671,1037,32196
2016,North Carolina,NC,SWAIN COUNTY,2196,3565,363,6124
2016,North Carolina,NC,TRANSYLVANIA COUNTY,6558,10520,791,17869
2016,North Carolina,NC,TYRRELL COUNTY,720,975,44,1739
2016,North Carolina,NC,UNION COUNTY,34337,66707,4666,105710
2016,North Carolina,NC,VANCE COUNTY,12229,7332,416,19977
2016,North Carolina,NC,WAKE COUNTY,302736,196082,28806,527624
2016,North Carolina,NC,WARREN COUNTY,6413,3214,215,9842
2016,North Carolina,NC,WASHINGTON COUNTY,3510,2564,91,6165
2016,North Carolina,NC,WATAUGA COUNTY,14138,13697,2150,29985
2016,North Carolina,NC,WAYNE COUNTY,21770,27540,1379,50689
2016,North Carolina,NC,WILKES COUNTY,6638,23752,906,31296
2016,North Carolina,NC,WILSON COUNTY,19663,17531,941,38135
2016,North Carolina,NC,YADKIN COUNTY,3160,13880,584,17624
2016,North Carolina,NC,YANCEY COUNTY,3196,6385,379,9960
2016,Ohio,OH,ADAMS COUNTY,2326,8659,374,11359
2016,Ohio,OH,ALLEN COUNTY,13294,30487,2113,45894
2016,Ohio,OH,ASHLAND COUNTY,5740,17493,1357,24590
2016,Ohio,OH,ASHTABULA COUNTY,15577,23318,1972,40867
2016,Ohio,OH,ATHENS COUNTY,16370,11354,1719,29443
2016,Ohio,OH,AUGLAIZE COUNTY,3980,18658,989,23627
2016,Ohio,OH,BELMONT COUNTY,8785,21108,1229,31122
2016,Ohio,OH,BROWN COUNTY,4353,14573,681,19607
2016,Ohio,OH,BUTLER COUNTY,58642,106976,8221,173839
2016,Ohio,OH,CARROLL COUNTY,3154,9254,666,13074
2016,Ohio,OH,CHAMPAIGN COUNTY,4594,12631,879,18104
2016,Ohio,OH,CLARK COUNTY,23328,35205,2896,61429
2016,Ohio,OH,CLERMONT COUNTY,26715,67518,4888,99121
2016,Ohio,OH,CLINTON COUNTY,4066,13838,771,18675
2016,Ohio,OH,COLUMBIANA COUNTY,12432,31676,2093,46201
2016,Ohio,OH,COSHOCTON COUNTY,4013,10785,754,15552
2016,Ohio,OH,CRAWFORD COUNTY,4625,13611,1001,19237
2016,Ohio,OH,CUYAHOGA COUNTY,398271,184211,21340,603822
2016,Ohio,OH,DARKE COUNTY,4470,20012,1002,25484
2016,Ohio,OH,DEFIANCE COUNTY,5368,11688,1136,18192
2016,Ohio,OH,DELAWARE COUNTY,40872,57568,5420,103860
2016,Ohio,OH,ERIE COUNTY,16057,19648,1873,37578
2016,Ohio,OH,FAIRFIELD COUNTY,24881,44314,3718,72913
2016,Ohio,OH,FAYETTE COUNTY,2739,7995,428,11162
2016,Ohio,OH,FRANKLIN COUNTY,351198,199331,30611,581140
2016,Ohio,OH,FULTON COUNTY,6069,13709,1447,21225
2016,Ohio,OH,GALLIA COUNTY,2628,9822,481,12931
2016,Ohio,OH,GEAUGA COUNTY,17569,30227,2145,49941
2016,Ohio,OH,GREENE COUNTY,28943,48540,4375,81858
2016,Ohio,OH,GUERNSEY COUNTY,4359,11445,753,16557
2016,Ohio,OH,HAMILTON COUNTY,215719,173665,19725,409109
2016,Ohio,OH,HANCOCK COUNTY,9609,24183,2231,36023
2016,Ohio,OH,HARDIN COUNTY,2920,8717,657,12294
2016,Ohio,OH,HARRISON COUNTY,1688,5098,293,7079
2016,Ohio,OH,HENRY COUNTY,3756,9301,875,13932
2016,Ohio,OH,HIGHLAND COUNTY,3773,14020,708,18501
2016,Ohio,OH,HOCKING COUNTY,3775,8497,566,12838
2016,Ohio,OH,HOLMES COUNTY,1788,8720,546,11054
2016,Ohio,OH,HURON COUNTY,7192,16226,1416,24834
2016,Ohio,OH,JACKSON COUNTY,3226,9949,518,13693
2016,Ohio,OH,JEFFERSON COUNTY,9675,21117,1409,32201
2016,Ohio,OH,KNOX COUNTY,8171,19131,1385,28687
2016,Ohio,OH,LAKE COUNTY,46397,64255,5594,116246
2016,Ohio,OH,LAWRENCE COUNTY,6974,18689,944,26607
2016,Ohio,OH,LICKING COUNTY,27376,51241,4144,82761
2016,Ohio,OH,LOGAN COUNTY,4647,15957,967,21571
2016,Ohio,OH,LORAIN COUNTY,66949,66818,6795,140562
2016,Ohio,OH,LUCAS COUNTY,110833,75698,11025,197556
2016,Ohio,OH,MADISON COUNTY,4779,11631,880,17290
2016,Ohio,OH,MAHONING COUNTY,57381,53616,4075,115072
2016,Ohio,OH,MARION COUNTY,7928,16961,1433,26322
2016,Ohio,OH,MEDINA COUNTY,32182,54810,4381,91373
2016,Ohio,OH,MEIGS COUNTY,2260,7309,416,9985
2016,Ohio,OH,MERCER COUNTY,3384,17506,836,21726
2016,Ohio,OH,MIAMI COUNTY,13120,37079,2535,52734
2016,Ohio,OH,MONROE COUNTY,1662,4868,265,6795
2016,Ohio,OH,MONTGOMERY COUNTY,122016,123909,12376,258301
2016,Ohio,OH,MORGAN COUNTY,1736,4431,276,6443
2016,Ohio,OH,MORROW COUNTY,3761,11948,839,16548
2016,Ohio,OH,MUSKINGUM COUNTY,11123,24056,1812,36991
2016,Ohio,OH,NOBLE COUNTY,1221,4549,243,6013
2016,Ohio,OH,OTTAWA COUNTY,8285,12653,1280,22218
2016,Ohio,OH,PAULDING COUNTY,2093,6500,454,9047
2016,Ohio,OH,PERRY COUNTY,4138,10228,629,14995
2016,Ohio,OH,PICKAWAY COUNTY,6529,17076,1140,24745
2016,Ohio,OH,PIKE COUNTY,3539,7902,438,11879
2016,Ohio,OH,PORTAGE COUNTY,32397,39971,3771,76139
2016,Ohio,OH,PREBLE COUNTY,4325,15446,794,20565
2016,Ohio,OH,PUTNAM COUNTY,2922,14961,884,18767
2016,Ohio,OH,RICHLAND COUNTY,16085,36590,2539,55214
2016,Ohio,OH,ROSS COUNTY,10356,18652,1372,30380
2016,Ohio,OH,SANDUSKY COUNTY,9929,16316,1799,28044
2016,Ohio,OH,SCIOTO COUNTY,9132,20550,1102,30784
2016,Ohio,OH,SENECA COUNTY,7404,14825,1758,23987
2016,Ohio,OH,SHELBY COUNTY,4243,18590,907,23740
2016,Ohio,OH,STARK COUNTY,68146,98388,8705,175239
2016,Ohio,OH,SUMMIT COUNTY,134256,112026,11697,257979
2016,Ohio,OH,TRUMBULL COUNTY,43014,49024,3991,96029
2016,Ohio,OH,TUSCARAWAS COUNTY,12188,26918,2183,41289
2016,Ohio,OH,UNION COUNTY,7718,18096,1615,27429
2016,Ohio,OH,VAN WERT COUNTY,2697,10469,604,13770
2016,Ohio,OH,VINTON COUNTY,1351,3883,268,5502
2016,Ohio,OH,WARREN COUNTY,33730,77643,5894,117267
2016,Ohio,OH,WASHINGTON COUNTY,8026,20514,1300,29840
2016,Ohio,OH,WAYNE COUNTY,15031,32270,2552,49853
2016,Ohio,OH,WILLIAMS COUNTY,4358,11939,1011,17308
2016,Ohio,OH,WOOD COUNTY,27318,32498,4525,64341
2016,Ohio,OH,WYANDOT COUNTY,2515,7468,609,10592
2016,Pennsylvania,PA,ADAMS COUNTY,14219,31423,1847,47489
2016,Pennsylvania,PA,ALLEGHENY COUNTY,367617,259480,23017,650114
2016,Pennsylvania,PA,ARMSTRONG COUNTY,7178,23484,956,31618
2016,Pennsylvania,PA,BEAVER COUNTY,32531,48167,2873,83571
2016,Pennsylvania,PA,BEDFORD COUNTY,3645,19552,440,23637
2016,Pennsylvania,PA,BERKS COUNTY,78437,96626,8002,183065
2016,Pennsylvania,PA,BLAIR COUNTY,13958,39135,1816,54909
2016,Pennsylvania,PA,BRADFORD COUNTY,6369,18141,1198,25708
2016,Pennsylvania,PA,BUCKS COUNTY,167060,164361,12876,344297
2016,Pennsylvania,PA,BUTLER COUNTY,28584,64428,4059,97071
2016,Pennsylvania,PA,CAMBRIA COUNTY,18867,42258,1947,63072
2016,Pennsylvania,PA,CAMERON COUNTY,531,1589,66,2186
2016,Pennsylvania,PA,CARBON COUNTY,8936,18743,1097,28776
2016,Pennsylvania,PA,CENTRE COUNTY,37088,35274,3786,76148
2016,Pennsylvania,PA,CHESTER COUNTY,141682,116114,11004,268800
2016,Pennsylvania,PA,CLARION COUNTY,4273,12576,686,17535
2016,Pennsylvania,PA,CLEARFIELD COUNTY,8200,24932,1139,34271
2016,Pennsylvania,PA,CLINTON COUNTY,4744,10022,628,15394
2016,Pennsylvania,PA,COLUMBIA COUNTY,8934,18004,1290,28228
2016,Pennsylvania,PA,CRAWFORD COUNTY,10971,24987,1534,37492
2016,Pennsylvania,PA,CUMBERLAND COUNTY,47085,69076,5456,121617
2016,Pennsylvania,PA,DAUPHIN COUNTY,64706,60863,5303,130872
2016,Pennsylvania,PA,DELAWARE COUNTY,177402,110667,9565,297634
2016,Pennsylvania,PA,ELK COUNTY,3853,10025,548,14426
2016,Pennsylvania,PA,ERIE COUNTY,58112,60069,5498,123679
2016,Pennsylvania,PA,FAYETTE COUNTY,17946,34590,1231,53767
2016,Pennsylvania,PA,FOREST COUNTY,626,1683,92,2401
2016,Pennsylvania,PA,FRANKLIN COUNTY,17465,49768,2498,69731
2016,Pennsylvania,PA,FULTON COUNTY,912,5694,165,6771
2016,Pennsylvania,PA,GREENE COUNTY,4482,10849,433,15764
2016,Pennsylvania,PA,HUNTINGDON COUNTY,4539,14494,673,19706
2016,Pennsylvania,PA,INDIANA COUNTY,11528,24888,1354,37770
2016,Pennsylvania,PA,JEFFERSON COUNTY,3650,15192,636,19478
2016,Pennsylvania,PA,JUNIATA COUNTY,1821,8273,360,10454
2016,Pennsylvania,PA,LACKAWANNA COUNTY,51983,48384,3089,103456
2016,Pennsylvania,PA,LANCASTER COUNTY,91093,137914,12105,241112
2016,Pennsylvania,PA,LAWRENCE COUNTY,14009,25428,1316,40753
2016,Pennsylvania,PA,LEBANON COUNTY,18953,40525,2367,61845
2016,Pennsylvania,PA,LEHIGH COUNTY,81324,73690,5979,160993
2016,Pennsylvania,PA,LUZERNE COUNTY,52451,78688,3844,134983
2016,Pennsylvania,PA,LYCOMING COUNTY,13020,35627,1918,50565
2016,Pennsylvania,PA,MCKEAN COUNTY,4025,11635,636,16296
2016,Pennsylvania,PA,MERCER COUNTY,18733,31544,2032,52309
2016,Pennsylvania,PA,MIFFLIN COUNTY,3877,14094,630,18601
2016,Pennsylvania,PA,MONROE COUNTY,33918,33386,2448,69752
2016,Pennsylvania,PA,MONTGOMERY COUNTY,256082,162731,15874,434687
2016,Pennsylvania,PA,MONTOUR COUNTY,2857,5288,411,8556
2016,Pennsylvania,PA,NORTHAMPTON COUNTY,66272,71736,5511,143519
2016,Pennsylvania,PA,NORTHUMBERLAND COUNTY,9788,25427,1407,36622
2016,Pennsylvania,PA,PERRY COUNTY,4632,15616,910,21158
2016,Pennsylvania,PA,PHILADELPHIA COUNTY,584025,108748,14858,707631
2016,Pennsylvania,PA,PIKE COUNTY,9256,16056,789,26101
2016,Pennsylvania,PA,POTTER COUNTY,1302,6251,231,7784
2016,Pennsylvania,PA,SCHUYLKILL COUNTY,16770,44001,2098,62869
2016,Pennsylvania,PA,SNYDER COUNTY,4002,11725,636,16363
2016,Pennsylvania,PA,SOMERSET COUNTY,7376,27379,1018,35773
2016,Pennsylvania,PA,SULLIVAN COUNTY,750,2291,95,3136
2016,Pennsylvania,PA,SUSQUEHANNA COUNTY,5123,12891,849,18863
2016,Pennsylvania,PA,TIOGA COUNTY,3901,13614,810,18325
2016,Pennsylvania,PA,UNION COUNTY,6180,10622,666,17468
2016,Pennsylvania,PA,VENANGO COUNTY,6309,16021,1018,23348
2016,Pennsylvania,PA,WARREN COUNTY,5145,12477,812,18434
2016,Pennsylvania,PA,WASHINGTON COUNTY,36322,61386,3742,101450
2016,Pennsylvania,PA,WAYNE COUNTY,7008,16244,766,24018
2016,Pennsylvania,PA,WESTMORELAND COUNTY,59669,116522,5860,182051
2016,Pennsylvania,PA,WYOMING COUNTY,3811,8837,496,13144
2016,Pennsylvania,PA,YORK COUNTY,68524,128528,8934,205986
2016,Wisconsin,WI,ADAMS COUNTY,3770,5983,411,10164
2016,Wisconsin,WI,ASHLAND COUNTY,4228,3302,499,8029
2016,Wisconsin,WI,BARRON COUNTY,7879,13606,1158,22643
2016,Wisconsin,WI,BAYFIELD COUNTY,4954,4125,450,9529
2016,Wisconsin,WI,BROWN COUNTY,53364,67199,8416,128979
2016,Wisconsin,WI,BUFFALO COUNTY,2531,4049,408,6988
2016,Wisconsin,WI,BURNETT COUNTY,2948,5412,383,8743
2016,Wisconsin,WI,CALUMET COUNTY,9646,15348,1656,26650
2016,Wisconsin,WI,CHIPPEWA COUNTY,11886,17909,1766,31561
2016,Wisconsin,WI,CLARK COUNTY,4227,8646,723,13596
2016,Wisconsin,WI,COLUMBIA COUNTY,13526,14160,2085,29771
2016,Wisconsin,WI,CRAWFORD COUNTY,3425,3844,475,7744
2016,Wisconsin,WI,DANE COUNTY,217526,71279,21212,310017
2016,Wisconsin,WI,DODGE COUNTY,13968,26643,2454,43065
2016,Wisconsin,WI,DOOR COUNTY,8026,8584,998,17608
2016,Wisconsin,WI,DOUGLAS COUNTY,11345,9659,1507,22511
2016,Wisconsin,WI,DUNN COUNTY,9026,11488,1577,22091
2016,Wisconsin,WI,EAU CLAIRE COUNTY,27294,23311,4280,54885
2016,Wisconsin,WI,FLORENCE COUNTY,666,1897,94,2657
2016,Wisconsin,WI,FOND DU LAC COUNTY,17391,31044,2892,51327
2016,Wisconsin,WI,FOREST COUNTY,1584,2788,168,4540
2016,Wisconsin,WI,GRANT COUNTY,10046,12349,1926,24321
2016,Wisconsin,WI,GREEN COUNTY,9122,8693,1170,18985
2016,Wisconsin,WI,GREEN LAKE COUNTY,2701,6213,474,9388
2016,Wisconsin,WI,IOWA COUNTY,6669,4809,782,12260
2016,Wisconsin,WI,IRON COUNTY,1273,2090,134,3497
2016,Wisconsin,WI,JACKSON COUNTY,3821,4907,544,9272
2016,Wisconsin,WI,JEFFERSON COUNTY,16561,23410,3175,43146
2016,Wisconsin,WI,JUNEAU COUNTY,4073,7123,536,11732
2016,Wisconsin,WI,KENOSHA COUNTY,35771,36025,5280,77076
2016,Wisconsin,WI,KEWAUNEE COUNTY,3623,6616,519,10758
2016,Wisconsin,WI,LA CROSSE COUNTY,32406,26389,4173,62968
2016,Wisconsin,WI,LAFAYETTE COUNTY,3288,3977,397,7662
2016,Wisconsin,WI,LANGLADE COUNTY,3260,6436,436,10132
2016,Wisconsin,WI,LINCOLN COUNTY,5370,8400,936,14706
2016,Wisconsin,WI,MANITOWOC COUNTY,14506,23193,2647,40346
2016,Wisconsin,WI,MARATHON COUNTY,26477,39013,4025,69515
2016,Wisconsin,WI,MARINETTE COUNTY,6243,12995,808,20046
2016,Wisconsin,WI,MARQUETTE COUNTY,2809,4714,370,7893
2016,Wisconsin,WI,MENOMINEE COUNTY,1003,269,7,1279
2016,Wisconsin,WI,MILWAUKEE COUNTY,288797,125846,25604,440247
2016,Wisconsin,WI,MONROE COUNTY,7048,11352,1270,19670
2016,Wisconsin,WI,OCONTO COUNTY,5884,13253,841,19978
2016,Wisconsin,WI,ONEIDA COUNTY,8104,12117,1252,21473
2016,Wisconsin,WI,OUTAGAMIE COUNTY,38087,49884,5897,93868
2016,Wisconsin,WI,OZAUKEE COUNTY,20168,30430,3925,54523
2016,Wisconsin,WI,PEPIN COUNTY,1345,2206,188,3739
2016,Wisconsin,WI,PIERCE COUNTY,8382,11258,1549,21189
2016,Wisconsin,WI,POLK COUNTY,7570,13815,1364,22749
2016,Wisconsin,WI,PORTAGE COUNTY,18521,17306,2669,38496
2016,Wisconsin,WI,PRICE COUNTY,2669,4562,346,7577
2016,Wisconsin,WI,RACINE COUNTY,42512,46611,5010,94133
2016,Wisconsin,WI,RICHLAND COUNTY,3577,4023,455,8055
2016,Wisconsin,WI,ROCK COUNTY,39343,31488,5237,76068
2016,Wisconsin,WI,RUSK COUNTY,2171,4564,352,7087
2016,Wisconsin,WI,ST. CROIX COUNTY,17486,26220,3802,47508
2016,Wisconsin,WI,SAUK COUNTY,14692,14791,1835,31318
2016,Wisconsin,WI,SAWYER COUNTY,3504,5185,432,9121
2016,Wisconsin,WI,SHAWANO COUNTY,6056,12742,953,19751
2016,Wisconsin,WI,SHEBOYGAN COUNTY,22956,32458,4241,59655
2016,Wisconsin,WI,TAYLOR COUNTY,2398,6589,497,9484
2016,Wisconsin,WI,TREMPEALEAU COUNTY,5636,7364,675,13675
2016,Wisconsin,WI,VERNON COUNTY,6352,6996,865,14213
2016,Wisconsin,WI,VILAS COUNTY,4770,8169,673,13612
2016,Wisconsin,WI,WALWORTH COUNTY,18706,28851,3767,51324
2016,Wisconsin,WI,WASHBURN COUNTY,3284,5404,460,9148
2016,Wisconsin,WI,WASHINGTON COUNTY,20855,51729,5419,78003
2016,Wisconsin,WI,WAUKESHA COUNTY,79200,142521,17321,239042
2016,Wisconsin,WI,WAUPACA COUNTY,8440,16189,1395,26024
2016,Wisconsin,WI,WAUSHARA COUNTY,3792,7669,538,11999
2016,Wisconsin,WI,WINNEBAGO COUNTY,37054,43448,6642,87144
2016,Wisconsin,WI,WOOD COUNTY,14232,21503,2065,37800
2020,Wisconsin,WI,ADAMS COUNTY,4329,7362,127,11818
2020,Wisconsin,WI,ASHLAND COUNTY,4794,3845,112,8751
2020,Wisconsin,WI,BARRON COUNTY,9188,15797,348,25333
2020,Wisconsin,WI,BAYFIELD COUNTY,6155,4617,113,10885
2020,Wisconsin,WI,BROWN COUNTY,65509,75865,2637,144011
2020,Wisconsin,WI,BUFFALO COUNTY,2859,4834,118,7811
2020,Wisconsin,WI,BURNETT COUNTY,3569,6461,111,10141
2020,Wisconsin,WI,CALUMET COUNTY,12115,18142,601,30858
2020,Wisconsin,WI,CHIPPEWA COUNTY,14001,21316,628,35945
2020,Wisconsin,WI,CLARK COUNTY,4520,10001,352,14873
2020,Wisconsin,WI,COLUMBIA COUNTY,16408,16925,584,33917
2020,Wisconsin,WI,CRAWFORD COUNTY,3953,4620,122,8695
2020,Wisconsin,WI,DANE COUNTY,260157,78789,5799,344745
2020,Wisconsin,WI,DODGE COUNTY,16355,31354,788,48497
2020,Wisconsin,WI,DOOR COUNTY,10044,9752,321,20117
2020,Wisconsin,WI,DOUGLAS COUNTY,13214,10919,535,24668
2020,Wisconsin,WI,DUNN COUNTY,9909,13176,458,23543
2020,Wisconsin,WI,EAU CLAIRE COUNTY,31617,25339,1279,58235
2020,Wisconsin,WI,FLORENCE COUNTY,781,2133,25,2939
2020,Wisconsin,WI,FOND DU LAC COUNTY,20588,35754,980,57322
2020,Wisconsin,WI,FOREST COUNTY,1722,3287,43,5052
2020,Wisconsin,WI,GRANT COUNTY,10942,13981,454,25377
2020,Wisconsin,WI,GREEN COUNTY,10850,10165,385,21400
2020,Wisconsin,WI,GREEN LAKE COUNTY,3344,7165,154,10663
2020,Wisconsin,WI,IOWA COUNTY,7828,5907,226,13961
2020,Wisconsin,WI,IRON COUNTY,1533,2439,59,4031
2020,Wisconsin,WI,JACKSON COUNTY,4255,5789,136,10180
2020,Wisconsin,WI,JEFFERSON COUNTY,19904,27209,854,47967
2020,Wisconsin,WI,JUNEAU COUNTY,4747,8749,207,13703
2020,Wisconsin,WI,KENOSHA COUNTY,42191,44972,1528,88691
2020,Wisconsin,WI,KEWAUNEE COUNTY,3977,7927,167,12071
2020,Wisconsin,WI,LA CROSSE COUNTY,37817,28661,1320,67798
2020,Wisconsin,WI,LAFAYETTE COUNTY,3647,4820,94,8561
2020,Wisconsin,WI,LANGLADE COUNTY,3703,7330,126,11159
2020,Wisconsin,WI,LINCOLN COUNTY,6260,10017,243,16520
2020,Wisconsin,WI,MANITOWOC COUNTY,16815,27217,774,44806
2020,Wisconsin,WI,MARATHON COUNTY,30807,44623,1311,76741
2020,Wisconsin,WI,MARINETTE COUNTY,7363,15303,293,22959
2020,Wisconsin,WI,MARQUETTE COUNTY,3239,5719,95,9053
2020,Wisconsin,WI,MENOMINEE COUNTY,1303,278,4,1585
2020,Wisconsin,WI,MILWAUKEE COUNTY,317251,134355,7329,458935
2020,Wisconsin,WI,MONROE COUNTY,8432,13775,397,22604
2020,Wisconsin,WI,OCONTO COUNTY,6715,16266,273,23254
2020,Wisconsin,WI,ONEIDA COUNTY,10105,13671,383,24159
2020,Wisconsin,WI,OUTAGAMIE COUNTY,47659,58379,2185,108223
2020,Wisconsin,WI,OZAUKEE COUNTY,26515,33912,1026,61453
2020,Wisconsin,WI,PEPIN COUNTY,1489,2584,67,4140
2020,Wisconsin,WI,PIERCE COUNTY,9789,12813,734,23336
2020,Wisconsin,WI,POLK COUNTY,9361,16590,374,26325
2020,Wisconsin,WI,PORTAGE COUNTY,20426,19298,878,40602
2020,Wisconsin,WI,PRICE COUNTY,3132,5394,119,8645
2020,Wisconsin,WI,RACINE COUNTY,50154,54475,1812,106441
2020,Wisconsin,WI,RICHLAND COUNTY,3963,4912,144,9019
2020,Wisconsin,WI,ROCK COUNTY,46649,37133,1566,85348
2020,Wisconsin,WI,RUSK COUNTY,2517,5257,113,7887
2020,Wisconsin,WI,SAUK COUNTY,18103,17489,657,36249
2020,Wisconsin,WI,SAWYER COUNTY,4494,5883,102,10479
2020,Wisconsin,WI,SHAWANO COUNTY,7131,15447,308,22886
2020,Wisconsin,WI,SHEBOYGAN COUNTY,27109,37624,1302,66035
2020,Wisconsin,WI,ST.CROIX COUNTY,23190,32190,1321,56701
2020,Wisconsin,WI,TAYLOR COUNTY,2693,7656,336,10685
2020,Wisconsin,WI,TREMPEALEAU COUNTY,6283,8828,248,15359
2020,Wisconsin,WI,VERNON COUNTY,7457,8216,237,15910
2020,Wisconsin,WI,VILAS COUNTY,5903,9261,174,15338
2020,Wisconsin,WI,WALWORTH COUNTY,22783,33844,961,57588
2020,Wisconsin,WI,WASHBURN COUNTY,3867,6332,176,10375
2020,Wisconsin,WI,WASHINGTON COUNTY,26647,60235,1372,88254
2020,Wisconsin,WI,WAUKESHA COUNTY,103867,159633,3659,267159
2020,Wisconsin,WI,WAUPACA COUNTY,9699,18948,440,29087
2020,Wisconsin,WI,WAUSHARA COUNTY,4388,9016,160,13564
2020,Wisconsin,WI,WINNEBAGO COUNTY,44060,47795,2177,94032
2020,Wisconsin,WI,WOOD COUNTY,16360,24306,530,41196
2020,Arizona,AZ,APACHE COUNTY,23293,11442,437,35172
2020,Arizona,AZ,COCHISE COUNTY,23732,35557,1153,60442
2020,Arizona,AZ,COCONINO COUNTY,44698,27052,1522,73272
2020,Arizona,AZ,GILA COUNTY,8943,18377,342,27662
2020,Arizona,AZ,GRAHAM COUNTY,4034,10749,212,14995
2020,Arizona,AZ,GREENLEE COUNTY,1182,2433,70,3685
2020,Arizona,AZ,LA PAZ COUNTY,2236,5129,93,7458
2020,Arizona,AZ,MARICOPA COUNTY,1040774,995665,31705,2068144
2020,Arizona,AZ,MOHAVE COUNTY,24831,78535,1302,104668
2020,Arizona,AZ,NAVAJO COUNTY,23383,27657,727,51767
2020,Arizona,AZ,PIMA COUNTY,304981,207758,7658,520397
2020,Arizona,AZ,PINAL COUNTY,75106,107077,2791,184974
2020,Arizona,AZ,SANTA CRUZ COUNTY,13138,6194,224,19556
2020,Arizona,AZ,YAVAPAI COUNTY,49602,91527,2092,143221
2020,Arizona,AZ,YUMA COUNTY,32210,36534,1137,69881
2020,Florida,FL,ALACHUA COUNTY,89704,50972,1928,142604
2020,Florida,FL,BAKER COUNTY,2037,11911,111,14059
2020,Florida,FL,BAY COUNTY,25614,66097,1313,93024
2020,Florida,FL,BRADFORD COUNTY,3160,10334,138,13632
2020,Florida,FL,BREVARD COUNTY,148549,207883,4332,360764
2020,Florida,FL,BROWARD COUNTY,618752,333409,5511,957672
2020,Florida,FL,CALHOUN COUNTY,1209,5274,43,6526
2020,Florida,FL,CHARLOTTE COUNTY,42273,73243,824,116340
2020,Florida,FL,CITRUS COUNTY,27092,65352,764,93208
2020,Florida,FL,CLAY COUNTY,38317,84480,1608,124405
2020,Florida,FL,COLLIER COUNTY,77621,128950,1247,207818
2020,Florida,FL,COLUMBIA COUNTY,8914,23836,292,33042
2020,Florida,FL,DESOTO COUNTY,4259,8313,87,12659
2020,Florida,FL,DIXIE COUNTY,1365,6759,43,8167
2020,Florida,FL,DUVAL COUNTY,252556,233762,6502,492820
2020,Florida,FL,ESCAMBIA COUNTY,70929,96674,2769,170372
2020,Florida,FL,FLAGLER COUNTY,28161,43043,512,71716
2020,Florida,FL,FRANKLIN COUNTY,2120,4675,54,6849
2020,Florida,FL,GADSDEN COUNTY,16153,7465,144,23762
2020,Florida,FL,GILCHRIST COUNTY,1700,7895,90,9685
2020,Florida,FL,GLADES COUNTY,1385,3782,26,5193
2020,Florida,FL,GULF COUNTY,1985,6113,65,8163
2020,Florida,FL,HAMILTON COUNTY,1963,3815,52,5830
2020,Florida,FL,HARDEE COUNTY,2298,6122,65,8485
2020,Florida,FL,HENDRY COUNTY,4929,7906,105,12940
2020,Florida,FL,HERNANDO COUNTY,37519,70412,991,108922
2020,Florida,FL,HIGHLANDS COUNTY,16938,34873,359,52170
2020,Florida,FL,HILLSBOROUGH COUNTY,376367,327398,8298,712063
2020,Florida,FL,HOLMES COUNTY,924,8080,64,9068
2020,Florida,FL,INDIAN RIVER COUNTY,37844,58872,768,97484
2020,Florida,FL,JACKSON COUNTY,6766,15488,165,22419
2020,Florida,FL,JEFFERSON COUNTY,3897,4479,75,8451
2020,Florida,FL,LAFAYETTE COUNTY,510,3128,20,3658
2020,Florida,FL,LAKE COUNTY,83505,125859,1950,211314
2020,Florida,FL,LEE COUNTY,157695,233247,2957,393899
2020,Florida,FL,LEON COUNTY,103517,57453,1959,162929
2020,Florida,FL,LEVY COUNTY,6205,16749,191,23145
2020,Florida,FL,LIBERTY COUNTY,694,2846,21,3561
2020,Florida,FL,MADISON COUNTY,3747,5576,57,9380
2020,Florida,FL,MANATEE COUNTY,90166,124987,1805,216958
2020,Florida,FL,MARION COUNTY,74858,127826,1692,204376
2020,Florida,FL,MARTIN COUNTY,36893,61168,665,98726
2020,Florida,FL,MIAMI-DADE COUNTY,617864,532833,6119,1156816
2020,Florida,FL,MONROE COUNTY,21881,25693,455,48029
2020,Florida,FL,NASSAU COUNTY,15564,42566,681,58811
2020,Florida,FL,OKALOOSA COUNTY,34248,79798,2327,116373
2020,Florida,FL,OKEECHOBEE COUNTY,4390,11470,94,15954
2020,Florida,FL,ORANGE COUNTY,395014,245398,6991,647403
2020,Florida,FL,OSCEOLA COUNTY,97297,73480,1659,172436
2020,Florida,FL,PALM BEACH COUNTY,433572,334711,4875,773158
2020,Florida,FL,PASCO COUNTY,119073,179621,3276,301970
2020,Florida,FL,PINELLAS COUNTY,277450,276209,6056,559715
2020,Florida,FL,POLK COUNTY,145049,194586,3621,343256
2020,Florida,FL,PUTNAM COUNTY,10527,25514,332,36373
2020,Florida,FL,SANTA ROSA COUNTY,27612,77385,1931,106928
2020,Florida,FL,SARASOTA COUNTY,120110,148370,2095,270575
2020,Florida,FL,SEMINOLE COUNTY,132528,125241,3046,260815
2020,Florida,FL,ST. JOHNS COUNTY,63850,110946,1826,176622
2020,Florida,FL,ST. LUCIE COUNTY,84137,86831,1201,172169
2020,Florida,FL,SUMTER COUNTY,29341,62761,383,92485
2020,Florida,FL,SUWANNEE COUNTY,4485,16410,162,21057
2020,Florida,FL,TAYLOR COUNTY,2299,7751,77,10127
2020,Florida,FL,UNION COUNTY,1053,5133,59,6245
2020,Florida,FL,VOLUSIA COUNTY,130575,173821,3043,307439
2020,Florida,FL,WAKULLA COUNTY,5351,12874,179,18404
2020,Florida,FL,WALTON COUNTY,10338,32947,426,43711
2020,Florida,FL,WASHINGTON COUNTY,2347,9876,104,12327
2020,Georgia,GA,APPLING COUNTY,1779,6526,36,8341
2020,Georgia,GA,ATKINSON COUNTY,825,2300,30,3155
2020,Georgia,GA,BACON COUNTY,625,4018,25,4668
2020,Georgia,GA,BAKER COUNTY,652,897,6,1555
2020,Georgia,GA,BALDWIN COUNTY,9140,8903,208,18251
2020,Georgia,GA,BANKS COUNTY,932,7795,74,8801
2020,Georgia,GA,BARROW COUNTY,10453,26804,664,37921
2020,Georgia,GA,BARTOW COUNTY,12092,37674,701,50467
2020,Georgia,GA,BEN HILL COUNTY,2392,4110,58,6560
2020,Georgia,GA,BERRIEN COUNTY,1269,6419,55,7743
2020,Georgia,GA,BIBB COUNTY,43468,26585,749,70802
2020,Georgia,GA,BLECKLEY COUNTY,1311,4328,67,5706
2020,Georgia,GA,BRANTLEY COUNTY,699,6991,56,7746
2020,Georgia,GA,BROOKS COUNTY,2790,4260,50,7100
2020,Georgia,GA,BRYAN COUNTY,6739,14244,357,21340
2020,Georgia,GA,BULLOCH COUNTY,11243,18386,455,30084
2020,Georgia,GA,BURKE COUNTY,5209,5400,75,10684
2020,Georgia,GA,BUTTS COUNTY,3274,8406,91,11771
2020,Georgia,GA,CALHOUN COUNTY,1260,923,11,2194
2020,Georgia,GA,CAMDEN COUNTY,7967,15251,470,23688
2020,Georgia,GA,CANDLER COUNTY,1269,3133,29,4431
2020,Georgia,GA,CARROLL COUNTY,16238,37476,760,54474
2020,Georgia,GA,CATOOSA COUNTY,6932,25167,494,32593
2020,Georgia,GA,CHARLTON COUNTY,1103,3419,44,4566
2020,Georgia,GA,CHATHAM COUNTY,78254,53237,1929,133420
2020,Georgia,GA,CHATTAHOOCHEE COUNTY,667,880,35,1582
2020,Georgia,GA,CHATTOOGA COUNTY,1854,8064,132,10050
2020,Georgia,GA,CHEROKEE COUNTY,42794,99587,2449,144830
2020,Georgia,GA,CLARKE COUNTY,36048,14446,839,51333
2020,Georgia,GA,CLAY COUNTY,790,637,7,1434
2020,Georgia,GA,CLAYTON COUNTY,95476,15813,1055,112344
2020,Georgia,GA,CLINCH COUNTY,747,2105,12,2864
2020,Georgia,GA,COBB COUNTY,221846,165459,6441,393746
2020,Georgia,GA,COFFEE COUNTY,4511,10578,125,15214
2020,Georgia,GA,COLQUITT COUNTY,4187,11777,119,16083
2020,Georgia,GA,COLUMBIA COUNTY,29236,50013,1330,80579
2020,Georgia,GA,COOK COUNTY,2059,4900,76,7035
2020,Georgia,GA,COWETA COUNTY,24210,51501,1088,76799
2020,Georgia,GA,CRAWFORD COUNTY,1615,4428,59,6102
2020,Georgia,GA,CRISP COUNTY,2986,4987,66,8039
2020,Georgia,GA,DADE COUNTY,1261,6066,107,7434
2020,Georgia,GA,DAWSON COUNTY,2486,13398,197,16081
2020,Georgia,GA,DECATUR COUNTY,4780,6758,89,11627
2020,Georgia,GA,DEKALB COUNTY,308227,58373,4204,370804
2020,Georgia,GA,DODGE COUNTY,2171,5843,56,8070
2020,Georgia,GA,DOOLY COUNTY,1911,2159,35,4105
2020,Georgia,GA,DOUGHERTY COUNTY,24577,10454,280,35311
2020,Georgia,GA,DOUGLAS COUNTY,42809,25451,837,69097
2020,Georgia,GA,EARLY COUNTY,2437,2722,28,5187
2020,Georgia,GA,ECHOLS COUNTY,167,1256,18,1441
2020,Georgia,GA,EFFINGHAM COUNTY,7720,23358,492,31570
2020,Georgia,GA,ELBERT COUNTY,2879,6226,66,9171
2020,Georgia,GA,EMANUEL COUNTY,2884,6551,66,9501
2020,Georgia,GA,EVANS COUNTY,1324,2888,35,4247
2020,Georgia,GA,FANNIN COUNTY,2571,12169,110,14850
2020,Georgia,GA,FAYETTE COUNTY,33065,37952,976,71993
2020,Georgia,GA,FLOYD COUNTY,12008,29123,517,41648
2020,Georgia,GA,FORSYTH COUNTY,42203,85122,1980,129305
2020,Georgia,GA,FRANKLIN COUNTY,1593,9069,103,10765
2020,Georgia,GA,FULTON COUNTY,381144,137240,6275,524659
2020,Georgia,GA,GILMER COUNTY,2932,13429,164,16525
2020,Georgia,GA,GLASCOCK COUNTY,155,1403,8,1566
2020,Georgia,GA,GLYNN COUNTY,15879,25616,489,41984
2020,Georgia,GA,GORDON COUNTY,4384,19405,244,24033
2020,Georgia,GA,GRADY COUNTY,3619,7034,54,10707
2020,Georgia,GA,GREENE COUNTY,4088,7068,91,11247
2020,Georgia,GA,GWINNETT COUNTY,241827,166413,5625,413865
2020,Georgia,GA,HABERSHAM COUNTY,3563,16637,232,20432
2020,Georgia,GA,HALL COUNTY,25031,64170,1322,90523
2020,Georgia,GA,HANCOCK COUNTY,2985,1159,21,4165
2020,Georgia,GA,HARALSON COUNTY,1792,12331,125,14248
2020,Georgia,GA,HARRIS COUNTY,5457,14319,215,19991
2020,Georgia,GA,HART COUNTY,3157,9464,106,12727
2020,Georgia,GA,HEARD COUNTY,824,4516,51,5391
2020,Georgia,GA,HENRY COUNTY,73276,48187,1279,122742
2020,Georgia,GA,HOUSTON COUNTY,32232,41534,1057,74823
2020,Georgia,GA,IRWIN COUNTY,1008,3134,26,4168
2020,Georgia,GA,JACKSON COUNTY,7642,29497,531,37670
2020,Georgia,GA,JASPER COUNTY,1761,5822,61,7644
2020,Georgia,GA,JEFF DAVIS COUNTY,1028,4695,48,5771
2020,Georgia,GA,JEFFERSON COUNTY,4061,3537,44,7642
2020,Georgia,GA,JENKINS COUNTY,1266,2161,28,3455
2020,Georgia,GA,JOHNSON COUNTY,1222,2850,28,4100
2020,Georgia,GA,JONES COUNTY,4888,9965,113,14966
2020,Georgia,GA,LAMAR COUNTY,2615,6330,94,9039
2020,Georgia,GA,LANIER COUNTY,1019,2509,48,3576
2020,Georgia,GA,LAURENS COUNTY,8073,14493,163,22729
2020,Georgia,GA,LEE COUNTY,4558,12007,149,16714
2020,Georgia,GA,LIBERTY COUNTY,13099,7959,331,21389
2020,Georgia,GA,LINCOLN COUNTY,1435,3179,36,4650
2020,Georgia,GA,LONG COUNTY,2033,3528,95,5656
2020,Georgia,GA,LOWNDES COUNTY,20117,25691,547,46355
2020,Georgia,GA,LUMPKIN COUNTY,3126,12163,242,15531
2020,Georgia,GA,MACON COUNTY,2857,1783,22,4662
2020,Georgia,GA,MADISON COUNTY,3411,11326,200,14937
2020,Georgia,GA,MARION COUNTY,1311,2275,38,3624
2020,Georgia,GA,MCDUFFIE COUNTY,4168,6169,118,10455
2020,Georgia,GA,MCINTOSH COUNTY,2612,4016,68,6696
2020,Georgia,GA,MERIWETHER COUNTY,4287,6524,66,10877
2020,Georgia,GA,MILLER COUNTY,749,2066,20,2835
2020,Georgia,GA,MITCHELL COUNTY,3995,4935,33,8963
2020,Georgia,GA,MONROE COUNTY,4384,11060,148,15592
2020,Georgia,GA,MONTGOMERY COUNTY,979,2960,27,3966
2020,Georgia,GA,MORGAN COUNTY,3355,8230,122,11707
2020,Georgia,GA,MURRAY COUNTY,2302,12943,144,15389
2020,Georgia,GA,MUSCOGEE COUNTY,49529,30049,965,80543
2020,Georgia,GA,NEWTON COUNTY,29794,23869,576,54239
2020,Georgia,GA,OCONEE COUNTY,8162,16595,411,25168
2020,Georgia,GA,OGLETHORPE COUNTY,2436,5593,102,8131
2020,Georgia,GA,PAULDING COUNTY,29704,54525,1156,85385
2020,Georgia,GA,PEACH COUNTY,5920,6502,123,12545
2020,Georgia,GA,PICKENS COUNTY,2808,14075,233,17116
2020,Georgia,GA,PIERCE COUNTY,1100,7899,49,9048
2020,Georgia,GA,PIKE COUNTY,1505,9127,88,10720
2020,Georgia,GA,POLK COUNTY,3658,13589,152,17399
2020,Georgia,GA,PULASKI COUNTY,1217,2805,37,4059
2020,Georgia,GA,PUTNAM COUNTY,3448,8291,116,11855
2020,Georgia,GA,QUITMAN COUNTY,497,604,5,1106
2020,Georgia,GA,RABUN COUNTY,1984,7474,110,9568
2020,Georgia,GA,RANDOLPH COUNTY,1671,1391,12,3074
2020,Georgia,GA,RICHMOND COUNTY,59124,26781,1111,87016
2020,Georgia,GA,ROCKDALE COUNTY,31244,13012,430,44686
2020,Georgia,GA,SCHLEY COUNTY,462,1800,13,2275
2020,Georgia,GA,SCREVEN COUNTY,2661,3916,51,6628
2020,Georgia,GA,SEMINOLE COUNTY,1254,2611,19,3884
2020,Georgia,GA,SPALDING COUNTY,11784,18057,275,30116
2020,Georgia,GA,STEPHENS COUNTY,2385,9368,132,11885
2020,Georgia,GA,STEWART COUNTY,1182,801,7,1990
2020,Georgia,GA,SUMTER COUNTY,6318,5732,100,12150
2020,Georgia,GA,TALBOT COUNTY,2114,1392,16,3522
2020,Georgia,GA,TALIAFERRO COUNTY,561,360,7,928
2020,Georgia,GA,TATTNALL COUNTY,2061,6053,69,8183
2020,Georgia,GA,TAYLOR COUNTY,1387,2418,34,3839
2020,Georgia,GA,TELFAIR COUNTY,1487,2825,21,4333
2020,Georgia,GA,TERRELL COUNTY,2376,2004,36,4416
2020,Georgia,GA,THOMAS COUNTY,8708,12954,191,21853
2020,Georgia,GA,TIFT COUNTY,5322,10784,177,16283
2020,Georgia,GA,TOOMBS COUNTY,2939,7872,103,10914
2020,Georgia,GA,TOWNS COUNTY,1550,6384,45,7979
2020,Georgia,GA,TREUTLEN COUNTY,952,2101,24,3077
2020,Georgia,GA,TROUP COUNTY,11578,18143,328,30049
2020,Georgia,GA,TURNER COUNTY,1410,2349,33,3792
2020,Georgia,GA,TWIGGS COUNTY,2044,2370,30,4444
2020,Georgia,GA,UNION COUNTY,2801,12651,108,15560
2020,Georgia,GA,UPSON COUNTY,4201,8608,96,12905
2020,Georgia,GA,WALKER COUNTY,5769,23174,411,29354
2020,Georgia,GA,WALTON COUNTY,12682,37842,571,51095
2020,Georgia,GA,WARE COUNTY,4211,9865,116,14192
2020,Georgia,GA,WARREN COUNTY,1469,1166,16,2651
2020,Georgia,GA,WASHINGTON COUNTY,4730,4663,66,9459
2020,Georgia,GA,WAYNE COUNTY,2687,9987,104,12778
2020,Georgia,GA,WEBSTER COUNTY,639,748,3,1390
2020,Georgia,GA,WHEELER COUNTY,689,1583,13,2285
2020,Georgia,GA,WHITE COUNTY,2411,12222,183,14816
2020,Georgia,GA,WHITFIELD COUNTY,10670,25636,440,36746
2020,Georgia,GA,WILCOX COUNTY,862,2403,16,3281
2020,Georgia,GA,WILKES COUNTY,2160,2823,46,5029
2020,Georgia,GA,WILKINSON COUNTY,2075,2664,31,4770
2020,Georgia,GA,WORTH COUNTY,2395,6830,60,9285
2020,Michigan,MI,ALCONA COUNTY,2142,4848,73,7063
2020,Michigan,MI,ALGER COUNTY,2053,3014,61,5128
2020,Michigan,MI,ALLEGAN COUNTY,24449,41392,1241,67082
2020,Michigan,MI,ALPENA COUNTY,6000,10686,280,16966
2020,Michigan,MI,ANTRIM COUNTY,5960,9748,241,15949
2020,Michigan,MI,ARENAC COUNTY,2774,5928,129,8831
2020,Michigan,MI,BARAGA COUNTY,1478,2512,46,4036
2020,Michigan,MI,BARRY COUNTY,11797,23471,637,35905
2020,Michigan,MI,BAY COUNTY,26151,33125,977,60253
2020,Michigan,MI,BENZIE COUNTY,5480,6601,179,12260
2020,Michigan,MI,BERRIEN COUNTY,37438,43519,1422,82379
2020,Michigan,MI,BRANCH COUNTY,6159,14064,313,20536
2020,Michigan,MI,CALHOUN COUNTY,28877,36221,1178,66276
2020,Michigan,MI,CASS COUNTY,9130,16699,384,26213
2020,Michigan,MI,CHARLEVOIX COUNTY,6939,9841,220,17000
2020,Michigan,MI,CHEBOYGAN COUNTY,5437,10186,245,15868
2020,Michigan,MI,CHIPPEWA COUNTY,6648,10681,311,17640
2020,Michigan,MI,CLARE COUNTY,5199,10861,221,16281
2020,Michigan,MI,CLINTON COUNTY,21968,25098,844,47910
2020,Michigan,MI,CRAWFORD COUNTY,2672,5087,102,7861
2020,Michigan,MI,DELTA COUNTY,7606,13207,338,21151
2020,Michigan,MI,DICKINSON COUNTY,4744,9617,228,14589
2020,Michigan,MI,EATON COUNTY,31299,31798,1207,64304
2020,Michigan,MI,EMMET COUNTY,9662,12135,379,22176
2020,Michigan,MI,GD. TRAVERSE COUNTY,28683,30502,1042,60227
2020,Michigan,MI,GENESEE COUNTY,119390,98714,3212,221316
2020,Michigan,MI,GLADWIN COUNTY,4524,9893,186,14603
2020,Michigan,MI,GOGEBIC COUNTY,3570,4600,96,8266
2020,Michigan,MI,GRATIOT COUNTY,6693,12102,331,19126
2020,Michigan,MI,HILLSDALE COUNTY,5883,17037,368,23288
2020,Michigan,MI,HOUGHTON COUNTY,7750,10378,373,18501
2020,Michigan,MI,HURON COUNTY,5490,12731,216,18437
2020,Michigan,MI,INGHAM COUNTY,94212,47639,2654,144505
2020,Michigan,MI,IONIA COUNTY,10901,20657,647,32205
2020,Michigan,MI,IOSCO COUNTY,5373,9759,227,15359
2020,Michigan,MI,IRON COUNTY,2493,4216,80,6789
2020,Michigan,MI,ISABELLA COUNTY,14072,14815,522,29409
2020,Michigan,MI,JACKSON COUNTY,31995,47372,1478,80845
2020,Michigan,MI,KALAMAZOO COUNTY,83686,56823,2867,143376
2020,Michigan,MI,KALKASKA COUNTY,3002,7436,192,10630
2020,Michigan,MI,KENT COUNTY,187915,165741,7183,360839
2020,Michigan,MI,KEWEENAW COUNTY,672,862,23,1557
2020,Michigan,MI,LAKE COUNTY,2288,3946,89,6323
2020,Michigan,MI,LAPEER COUNTY,16367,35482,791,52640
2020,Michigan,MI,LEELANAU COUNTY,8795,7916,187,16898
2020,Michigan,MI,LENAWEE COUNTY,20918,31541,915,53374
2020,Michigan,MI,LIVINGSTON COUNTY,48220,76982,1964,127166
2020,Michigan,MI,LUCE COUNTY,842,2109,50,3001
2020,Michigan,MI,MACKINAC COUNTY,2632,4304,79,7015
2020,Michigan,MI,MACOMB COUNTY,223952,263863,6404,494219
2020,Michigan,MI,MANISTEE COUNTY,6107,8321,226,14654
2020,Michigan,MI,MARQUETTE COUNTY,20465,16286,707,37458
2020,Michigan,MI,MASON COUNTY,6802,10207,240,17249
2020,Michigan,MI,MECOSTA COUNTY,7375,13267,404,21046
2020,Michigan,MI,MENOMINEE COUNTY,4316,8117,173,12606
2020,Michigan,MI,MIDLAND COUNTY,20493,27675,905,49073
2020,Michigan,MI,MISSAUKEE COUNTY,1967,6648,139,8754
2020,Michigan,MI,MONROE COUNTY,32975,52710,1463,87148
2020,Michigan,MI,MONTCALM COUNTY,9703,21815,568,32086
2020,Michigan,MI,MONTMORENCY COUNTY,1628,4171,60,5859
2020,Michigan,MI,MUSKEGON COUNTY,45643,45133,1659,92435
2020,Michigan,MI,NEWAYGO COUNTY,7873,18857,426,27156
2020,Michigan,MI,OAKLAND COUNTY,434148,325971,10090,770209
2020,Michigan,MI,OCEANA COUNTY,4944,8892,226,14062
2020,Michigan,MI,OGEMAW COUNTY,3475,8253,179,11907
2020,Michigan,MI,ONTONAGON COUNTY,1391,2358,55,3804
2020,Michigan,MI,OSCEOLA COUNTY,3214,8928,187,12329
2020,Michigan,MI,OSCODA COUNTY,1342,3466,66,4874
2020,Michigan,MI,OTSEGO COUNTY,4743,9779,234,14756
2020,Michigan,MI,OTTAWA COUNTY,64705,100913,3009,168627
2020,Michigan,MI,PRESQUE ISLE COUNTY,2911,5342,89,8342
2020,Michigan,MI,ROSCOMMON COUNTY,5166,9670,182,15018
2020,Michigan,MI,SAGINAW COUNTY,51088,50785,1474,103347
2020,Michigan,MI,SANILAC COUNTY,5966,16194,286,22446
2020,Michigan,MI,SCHOOLCRAFT COUNTY,1589,3090,66,4745
2020,Michigan,MI,SHIAWASSEE COUNTY,15347,23149,724,39220
2020,Michigan,MI,ST. CLAIR COUNTY,31363,59185,1515,92063
2020,Michigan,MI,ST. JOSEPH COUNTY,9262,18127,546,27935
2020,Michigan,MI,TUSCOLA COUNTY,8712,20297,433,29442
2020,Michigan,MI,VAN BUREN COUNTY,16803,21591,669,39063
2020,Michigan,MI,WASHTENAW COUNTY,157136,56241,2903,216280
2020,Michigan,MI,WAYNE COUNTY,597170,264553,10660,872383
2020,Michigan,MI,WEXFORD COUNTY,5838,12102,325,18265
2020,North Carolina,NC,ALAMANCE COUNTY,38825,46056,1210,86091
2020,North Carolina,NC,ALEXANDER COUNTY,4145,15888,203,20236
2020,North Carolina,NC,ALLEGHANY COUNTY,1486,4527,63,6076
2020,North Carolina,NC,ANSON COUNTY,5789,5321,84,11194
2020,North Carolina,NC,ASHE COUNTY,4164,11451,199,15814
2020,North Carolina,NC,AVERY COUNTY,2191,7172,95,9458
2020,North Carolina,NC,BEAUFORT COUNTY,9633,16437,245,26315
2020,North Carolina,NC,BERTIE COUNTY,5939,3817,59,9815
2020,North Carolina,NC,BLADEN COUNTY,7326,9676,123,17125
2020,North Carolina,NC,BRUNSWICK COUNTY,33310,55850,1015,90175
2020,North Carolina,NC,BUNCOMBE COUNTY,96515,62412,2642,161569
2020,North Carolina,NC,BURKE COUNTY,13118,31019,465,44602
2020,North Carolina,NC,CABARRUS COUNTY,52162,63237,1828,117227
2020,North Carolina,NC,CALDWELL COUNTY,10245,32119,465,42829
2020,North Carolina,NC,CAMDEN COUNTY,1537,4312,104,5953
2020,North Carolina,NC,CARTERET COUNTY,12093,30028,574,42695
2020,North Carolina,NC,CASWELL COUNTY,4860,7089,102,12051
2020,North Carolina,NC,CATAWBA COUNTY,25689,56588,1148,83425
2020,North Carolina,NC,CHATHAM COUNTY,26787,21186,626,48599
2020,North Carolina,NC,CHEROKEE COUNTY,3583,12628,212,16423
2020,North Carolina,NC,CHOWAN COUNTY,3247,4471,66,7784
2020,North Carolina,NC,CLAY COUNTY,1699,5112,82,6893
2020,North Carolina,NC,CLEVELAND COUNTY,16955,33798,555,51308
2020,North Carolina,NC,COLUMBUS COUNTY,9446,16832,168,26446
2020,North Carolina,NC,CRAVEN COUNTY,21148,31032,885,53065
2020,North Carolina,NC,CUMBERLAND COUNTY,84469,60032,2649,147150
2020,North Carolina,NC,CURRITUCK COUNTY,4195,11657,295,16147
2020,North Carolina,NC,DARE COUNTY,9936,13938,358,24232
2020,North Carolina,NC,DAVIDSON COUNTY,22636,64658,1220,88514
2020,North Carolina,NC,DAVIE COUNTY,6713,18228,370,25311
2020,North Carolina,NC,DUPLIN COUNTY,8767,13793,155,22715
2020,North Carolina,NC,DURHAM COUNTY,144688,32459,2767,179914
2020,North Carolina,NC,EDGECOMBE COUNTY,16089,9206,182,25477
2020,North Carolina,NC,FORSYTH COUNTY,113029,85060,3173,201262
2020,North Carolina,NC,FRANKLIN COUNTY,15882,20904,571,37357
2020,North Carolina,NC,GASTON COUNTY,40959,73033,1506,115498
2020,North Carolina,NC,GATES COUNTY,2546,3367,58,5971
2020,North Carolina,NC,GRAHAM COUNTY,905,3710,50,4665
2020,North Carolina,NC,GRANVILLE COUNTY,14565,16647,386,31598
2020,North Carolina,NC,GREENE COUNTY,3832,4874,47,8753
2020,North Carolina,NC,GUILFORD COUNTY,173086,107294,4106,284486
2020,North Carolina,NC,HALIFAX COUNTY,15545,10080,134,25759
2020,North Carolina,NC,HARNETT COUNTY,22093,35177,1023,58293
2020,North Carolina,NC,HAYWOOD COUNTY,13144,22834,564,36542
2020,North Carolina,NC,HENDERSON COUNTY,27211,40032,1128,68371
2020,North Carolina,NC,HERTFORD COUNTY,7097,3479,58,10634
2020,North Carolina,NC,HOKE COUNTY,11804,9453,382,21639
2020,North Carolina,NC,HYDE COUNTY,1046,1418,28,2492
2020,North Carolina,NC,IREDELL COUNTY,33888,67010,1473,102371
2020,North Carolina,NC,JACKSON COUNTY,9591,11356,481,21428
2020,North Carolina,NC,JOHNSTON COUNTY,41257,68353,1747,111357
2020,North Carolina,NC,JONES COUNTY,2197,3280,48,5525
2020,North Carolina,NC,LEE COUNTY,12143,16469,396,29008
2020,North Carolina,NC,LENOIR COUNTY,13605,14590,214,28409
2020,North Carolina,NC,LINCOLN COUNTY,13274,36341,602,50217
2020,North Carolina,NC,MACON COUNTY,6230,14211,302,20743
2020,North Carolina,NC,MADISON COUNTY,4901,7979,196,13076
2020,North Carolina,NC,MARTIN COUNTY,5911,6532,97,12540
2020,North Carolina,NC,MCDOWELL COUNTY,5832,16883,288,23003
2020,North Carolina,NC,MECKLENBURG COUNTY,378107,179211,9735,567053
2020,North Carolina,NC,MITCHELL COUNTY,1867,7090,84,9041
2020,North Carolina,NC,MONTGOMERY COUNTY,4327,8411,111,12849
2020,North Carolina,NC,MOORE COUNTY,20779,36764,796,58339
2020,North Carolina,NC,NASH COUNTY,25947,25827,497,52271
2020,North Carolina,NC,NEW HANOVER COUNTY,66146,63333,2361,131840
2020,North Carolina,NC,NORTHAMPTON COUNTY,6069,3989,52,10110
2020,North Carolina,NC,ONSLOW COUNTY,24266,46078,1891,72235
2020,North Carolina,NC,ORANGE COUNTY,63594,20176,1227,84997
2020,North Carolina,NC,PAMLICO COUNTY,2713,4849,69,7631
2020,North Carolina,NC,PASQUOTANK COUNTY,9832,9770,295,19897
2020,North Carolina,NC,PENDER COUNTY,11723,21956,490,34169
2020,North Carolina,NC,PERQUIMANS COUNTY,2492,4903,89,7484
2020,North Carolina,NC,PERSON COUNTY,8465,13184,245,21894
2020,North Carolina,NC,PITT COUNTY,47252,38982,1339,87573
2020,North Carolina,NC,POLK COUNTY,4518,7689,151,12358
2020,North Carolina,NC,RANDOLPH COUNTY,15618,56894,804,73316
2020,North Carolina,NC,RICHMOND COUNTY,8754,11830,179,20763
2020,North Carolina,NC,ROBESON COUNTY,19020,27806,362,47188
2020,North Carolina,NC,ROCKINGHAM COUNTY,15992,31301,516,47809
2020,North Carolina,NC,ROWAN COUNTY,23114,49297,997,73408
2020,North Carolina,NC,RUTHERFORD COUNTY,9135,24891,403,34429
2020,North Carolina,NC,SAMPSON COUNTY,10966,17411,241,28618
2020,North Carolina,NC,SCOTLAND COUNTY,7186,7473,116,14775
2020,North Carolina,NC,STANLY COUNTY,8129,25458,352,33939
2020,North Carolina,NC,STOKES COUNTY,5286,20144,273,25703
2020,North Carolina,NC,SURRY COUNTY,8721,27538,379,36638
2020,North Carolina,NC,SWAIN COUNTY,2780,4161,127,7068
2020,North Carolina,NC,TRANSYLVANIA COUNTY,8444,11636,324,20404
2020,North Carolina,NC,TYRRELL COUNTY,758,1044,15,1817
2020,North Carolina,NC,UNION COUNTY,48725,80382,1904,131011
2020,North Carolina,NC,VANCE COUNTY,12431,8391,177,20999
2020,North Carolina,NC,WAKE COUNTY,393336,226197,12297,631830
2020,North Carolina,NC,WARREN COUNTY,6400,3752,141,10293
2020,North Carolina,NC,WASHINGTON COUNTY,3396,2781,28,6205
2020,North Carolina,NC,WATAUGA COUNTY,17122,14451,647,32220
2020,North Carolina,NC,WAYNE COUNTY,24215,30709,613,55537
2020,North Carolina,NC,WILKES COUNTY,7511,27592,363,35466
2020,North Carolina,NC,WILSON COUNTY,20754,19581,400,40735
2020,North Carolina,NC,YADKIN COUNTY,3763,15933,227,19923
2020,North Carolina,NC,YANCEY COUNTY,3688,7516,148,11352
2020,Ohio,OH,ADAMS COUNTY,2130,9660,115,11905
2020,Ohio,OH,ALLEN COUNTY,13611,32052,712,46375
2020,Ohio,OH,ASHLAND COUNTY,6448,19002,440,25890
2020,Ohio,OH,ASHTABULA COUNTY,16207,26225,734,43166
2020,Ohio,OH,ATHENS COUNTY,14047,10386,385,24818
2020,Ohio,OH,AUGLAIZE COUNTY,4583,20451,318,25352
2020,Ohio,OH,BELMONT COUNTY,9011,23110,380,32501
2020,Ohio,OH,BROWN COUNTY,4326,16032,228,20586
2020,Ohio,OH,BUTLER COUNTY,67729,111722,2645,182096
2020,Ohio,OH,CARROLL COUNTY,3206,10525,208,13939
2020,Ohio,OH,CHAMPAIGN COUNTY,4946,14086,307,19339
2020,Ohio,OH,CLARK COUNTY,23625,38217,1057,62899
2020,Ohio,OH,CLERMONT COUNTY,33505,73077,1766,108348
2020,Ohio,OH,CLINTON COUNTY,4556,15061,326,19943
2020,Ohio,OH,COLUMBIANA COUNTY,13183,35124,761,49068
2020,Ohio,OH,COSHOCTON COUNTY,4057,11982,280,16319
2020,Ohio,OH,CRAWFORD COUNTY,4831,15043,321,20195
2020,Ohio,OH,CUYAHOGA COUNTY,402315,195089,6460,603864
2020,Ohio,OH,DARKE COUNTY,4668,21569,390,26627
2020,Ohio,OH,DEFIANCE COUNTY,5870,12778,353,19001
2020,Ohio,OH,DELAWARE COUNTY,56961,65163,1931,124055
2020,Ohio,OH,ERIE COUNTY,17142,21724,664,39530
2020,Ohio,OH,FAIRFIELD COUNTY,30634,49714,1250,81598
2020,Ohio,OH,FAYETTE COUNTY,2911,9220,161,12292
2020,Ohio,OH,FRANKLIN COUNTY,391584,203154,9613,604351
2020,Ohio,OH,FULTON COUNTY,6545,15396,363,22304
2020,Ohio,OH,GALLIA COUNTY,2911,10289,158,13358
2020,Ohio,OH,GEAUGA COUNTY,20980,33581,666,55227
2020,Ohio,OH,GREENE COUNTY,34023,50937,1682,86642
2020,Ohio,OH,GUERNSEY COUNTY,4498,13077,233,17808
2020,Ohio,OH,HAMILTON COUNTY,238101,173015,6467,417583
2020,Ohio,OH,HANCOCK COUNTY,11535,25796,682,38013
2020,Ohio,OH,HARDIN COUNTY,3025,9698,231,12954
2020,Ohio,OH,HARRISON COUNTY,1742,5668,90,7500
2020,Ohio,OH,HENRY COUNTY,3995,10273,215,14483
2020,Ohio,OH,HIGHLAND COUNTY,3741,15369,192,19302
2020,Ohio,OH,HOCKING COUNTY,3836,9554,205,13595
2020,Ohio,OH,HOLMES COUNTY,1981,10645,152,12778
2020,Ohio,OH,HURON COUNTY,7643,18537,453,26633
2020,Ohio,OH,JACKSON COUNTY,3193,10804,163,14160
2020,Ohio,OH,JEFFERSON COUNTY,9823,22309,499,32631
2020,Ohio,OH,KNOX COUNTY,8433,21825,454,30712
2020,Ohio,OH,LAKE COUNTY,54337,71615,1648,127600
2020,Ohio,OH,LAWRENCE COUNTY,7353,19759,319,27431
2020,Ohio,OH,LICKING COUNTY,32324,57965,1590,91879
2020,Ohio,OH,LOGAN COUNTY,4990,17625,332,22947
2020,Ohio,OH,LORAIN COUNTY,72792,76719,2157,151668
2020,Ohio,OH,LUCAS COUNTY,111989,79628,3328,194945
2020,Ohio,OH,MADISON COUNTY,5558,13445,313,19316
2020,Ohio,OH,MAHONING COUNTY,56346,58601,1401,116348
2020,Ohio,OH,MARION COUNTY,8089,18526,511,27126
2020,Ohio,OH,MEDINA COUNTY,39326,63451,1387,104164
2020,Ohio,OH,MEIGS COUNTY,2452,8163,140,10755
2020,Ohio,OH,MERCER COUNTY,3981,19145,277,23403
2020,Ohio,OH,MIAMI COUNTY,15420,40531,917,56868
2020,Ohio,OH,MONROE COUNTY,1597,5392,77,7066
2020,Ohio,OH,MONTGOMERY COUNTY,131592,126085,4275,261952
2020,Ohio,OH,MORGAN COUNTY,1703,4932,77,6712
2020,Ohio,OH,MORROW COUNTY,3988,13784,321,18093
2020,Ohio,OH,MUSKINGUM COUNTY,11755,27334,609,39698
2020,Ohio,OH,NOBLE COUNTY,1156,5024,36,6216
2020,Ohio,OH,OTTAWA COUNTY,8847,14285,356,23488
2020,Ohio,OH,PAULDING COUNTY,2172,6927,163,9262
2020,Ohio,OH,PERRY COUNTY,4006,11959,214,16179
2020,Ohio,OH,PICKAWAY COUNTY,7167,20059,363,27589
2020,Ohio,OH,PIKE COUNTY,3051,8872,140,12063
2020,Ohio,OH,PORTAGE COUNTY,34935,45034,1167,81136
2020,Ohio,OH,PREBLE COUNTY,4435,16697,290,21422
2020,Ohio,OH,PUTNAM COUNTY,3152,16218,307,19677
2020,Ohio,OH,RICHLAND COUNTY,17231,40534,836,58601
2020,Ohio,OH,ROSS COUNTY,10345,21687,437,32469
2020,Ohio,OH,SANDUSKY COUNTY,10391,18487,558,29436
2020,Ohio,OH,SCIOTO COUNTY,8876,21926,347,31149
2020,Ohio,OH,SENECA COUNTY,8147,16739,437,25323
2020,Ohio,OH,SHELBY COUNTY,4399,19988,364,24751
2020,Ohio,OH,STARK COUNTY,74336,108610,2800,185746
2020,Ohio,OH,SUMMIT COUNTY,148151,122023,3816,273990
2020,Ohio,OH,TRUMBULL COUNTY,43534,53756,1240,98530
2020,Ohio,OH,TUSCARAWAS COUNTY,12643,29519,632,42794
2020,Ohio,OH,UNION COUNTY,10985,21233,620,32838
2020,Ohio,OH,VAN WERT COUNTY,3026,11470,237,14733
2020,Ohio,OH,VINTON COUNTY,1306,4525,63,5894
2020,Ohio,OH,WARREN COUNTY,45040,85069,1983,132092
2020,Ohio,OH,WASHINGTON COUNTY,9114,21798,470,31382
2020,Ohio,OH,WAYNE COUNTY,16340,36059,828,53227
2020,Ohio,OH,WILLIAMS COUNTY,4726,13218,348,18292
2020,Ohio,OH,WOOD COUNTY,29797,34815,1194,65806
2020,Ohio,OH,WYANDOT COUNTY,2690,8248,186,11124
2020,Pennsylvania,PA,ADAMS COUNTY,18207,37523,810,56540
2020,Pennsylvania,PA,ALLEGHENY COUNTY,429065,282324,8344,719733
2020,Pennsylvania,PA,ARMSTRONG COUNTY,8453,27479,424,36356
2020,Pennsylvania,PA,BEAVER COUNTY,36521,54113,1223,91857
2020,Pennsylvania,PA,BEDFORD COUNTY,4367,23025,182,27574
2020,Pennsylvania,PA,BERKS COUNTY,92892,109727,2909,205528
2020,Pennsylvania,PA,BLAIR COUNTY,17636,45306,653,63595
2020,Pennsylvania,PA,BRADFORD COUNTY,8046,21600,513,30159
2020,Pennsylvania,PA,BUCKS COUNTY,204712,187367,4155,396234
2020,Pennsylvania,PA,BUTLER COUNTY,37379,74279,1432,113090
2020,Pennsylvania,PA,CAMBRIA COUNTY,21730,48085,759,70574
2020,Pennsylvania,PA,CAMERON COUNTY,634,1771,29,2434
2020,Pennsylvania,PA,CARBON COUNTY,11212,21984,433,33629
2020,Pennsylvania,PA,CENTRE COUNTY,40055,36372,1066,77493
2020,Pennsylvania,PA,CHESTER COUNTY,182372,128565,3565,314502
2020,Pennsylvania,PA,CLARION COUNTY,4678,14578,237,19493
2020,Pennsylvania,PA,CLEARFIELD COUNTY,9598,28984,542,39124
2020,Pennsylvania,PA,CLINTON COUNTY,5502,11902,221,17625
2020,Pennsylvania,PA,COLUMBIA COUNTY,10289,19752,528,30569
2020,Pennsylvania,PA,CRAWFORD COUNTY,12924,28559,521,42004
2020,Pennsylvania,PA,CUMBERLAND COUNTY,62245,77212,2138,141595
2020,Pennsylvania,PA,DAUPHIN COUNTY,78977,66404,1977,147358
2020,Pennsylvania,PA,DELAWARE COUNTY,206423,118532,2976,327931
2020,Pennsylvania,PA,ELK COUNTY,4522,12140,244,16906
2020,Pennsylvania,PA,ERIE COUNTY,68286,66869,1928,137083
2020,Pennsylvania,PA,FAYETTE COUNTY,19990,40551,462,61003
2020,Pennsylvania,PA,FOREST COUNTY,728,1882,36,2646
2020,Pennsylvania,PA,FRANKLIN COUNTY,22422,57245,1116,80783
2020,Pennsylvania,PA,FULTON COUNTY,1085,6824,68,7977
2020,Pennsylvania,PA,GREENE COUNTY,4911,12578,179,17668
2020,Pennsylvania,PA,HUNTINGDON COUNTY,5445,17061,286,22792
2020,Pennsylvania,PA,INDIANA COUNTY,12634,28089,475,41198
2020,Pennsylvania,PA,JEFFERSON COUNTY,4527,17960,337,22824
2020,Pennsylvania,PA,JUNIATA COUNTY,2253,9649,141,12043
2020,Pennsylvania,PA,LACKAWANNA COUNTY,61991,52332,1085,115408
2020,Pennsylvania,PA,LANCASTER COUNTY,115847,160209,4183,280239
2020,Pennsylvania,PA,LAWRENCE COUNTY,15978,29597,501,46076
2020,Pennsylvania,PA,LEBANON COUNTY,23932,46731,989,71652
2020,Pennsylvania,PA,LEHIGH COUNTY,98498,84418,2176,185092
2020,Pennsylvania,PA,LUZERNE COUNTY,64873,86929,1519,153321
2020,Pennsylvania,PA,LYCOMING COUNTY,16971,41462,821,59254
2020,Pennsylvania,PA,MCKEAN COUNTY,5076,14067,284,19427
2020,Pennsylvania,PA,MERCER COUNTY,21067,36143,744,57954
2020,Pennsylvania,PA,MIFFLIN COUNTY,4603,16670,229,21502
2020,Pennsylvania,PA,MONROE COUNTY,43038,37989,1018,82045
2020,Pennsylvania,PA,MONTGOMERY COUNTY,319511,185460,5186,510157
2020,Pennsylvania,PA,MONTOUR COUNTY,3771,5844,156,9771
2020,Pennsylvania,PA,NORTHAMPTON COUNTY,85006,83796,2000,170802
2020,Pennsylvania,PA,NORTHUMBERLAND COUNTY,12677,28952,654,42283
2020,Pennsylvania,PA,PERRY COUNTY,5950,18293,409,24652
2020,Pennsylvania,PA,PHILADELPHIA COUNTY,604175,132870,4854,741899
2020,Pennsylvania,PA,PIKE COUNTY,13019,19213,322,32554
2020,Pennsylvania,PA,POTTER COUNTY,1726,7239,99,9064
2020,Pennsylvania,PA,SCHUYLKILL COUNTY,20722,48868,1004,70594
2020,Pennsylvania,PA,SNYDER COUNTY,4910,13983,247,19140
2020,Pennsylvania,PA,SOMERSET COUNTY,8543,31105,414,40062
2020,Pennsylvania,PA,SULLIVAN COUNTY,921,2619,55,3595
2020,Pennsylvania,PA,SUSQUEHANNA COUNTY,6084,14879,301,21264
2020,Pennsylvania,PA,TIOGA COUNTY,4955,15742,378,21075
2020,Pennsylvania,PA,UNION COUNTY,7475,12356,284,20115
2020,Pennsylvania,PA,VENANGO COUNTY,7585,18569,374,26528
2020,Pennsylvania,PA,WARREN COUNTY,6066,14237,347,20650
2020,Pennsylvania,PA,WASHINGTON COUNTY,44706,71347,1298,117351
2020,Pennsylvania,PA,WAYNE COUNTY,9191,18637,261,28089
2020,Pennsylvania,PA,WESTMORELAND COUNTY,72122,130209,2350,204681
2020,Pennsylvania,PA,WYOMING COUNTY,4704,9936,218,14858
2020,Pennsylvania,PA,YORK COUNTY,88113,146728,3624,238465
